Lost in the Woods
Escape the Woods by Goran Filini?
Release 1 / Serial number 230109 / Inform 7 v10.1.2 / D

forest
You are in a dense forest, surrounded by tall trees and thick underbrush. It's hard to see more than a few feet in any direction. The trees are tall and their leaves rustle softly in the breeze. You can hear the distant sound of a stream nearby. The air is fresh and cool, and the ground is soft beneath you. It looks like you are alone in the forest.

What is your name?

>Boomer
You wake up feeling dizzy. You try to get a grasp of your surroundings That's not a verb I recognise.

>w
garden
The garden is a small, overgrown patch of land located in front of the  hut. The garden is surrounded by a high, wooden fence, topped with barbed wire and warning signs. The fence serves to keep out intruders and to protect the rare and exotic plants that grow within.

The ground is thick with weeds and moss, and the air is heavy with the aroma of herbs and spices. The plants in the garden are a mishmash of medicinal and poisonous varieties, carefully tended to by someone. There are rows of medicinal herbs such as lavender, basil, and chamomile, as well as deadly nightshade, mandrake root, and henbane.

In the center of the garden is a large, ancient oak tree, its branches gnarled and twisted. The tree is said to be enchanted, and is the source of much of the witch's power. It is said that if you are brave enough to pluck a leaf from the tree, you will be granted a wish. But be warned, you get the feeling something is fiercely protective of  garden and will not hesitate to dispose anyone who tries to harm it.

Overall, the  garden is a mysterious and dangerous place, filled with secrets and magic. It is a place to be respected and feared, but also one of great power and potential.

The mysterious vine door prevents you from entering the hut, maybe the piercing green eyed cat can help you enter, you think to yourself.

Nero gazes upon you with his piercing green eyes, smirking.

>ask nero about what now
Nero: You should try to pick the flower on top of the mountain peak so you can unlock the doors

>e
forest
You are standing in a dense forest, surrounded by tall trees and thick underbrush. It's hard to see more than a few feet in any direction. You have no idea how you ended up here, but you know you need to find your way out.

>ask nero about what now
You can't see any such thing.

>w
garden
The garden is a small, overgrown patch of land located in front of the  hut. The garden is surrounded by a high, wooden fence, topped with barbed wire and warning signs. The fence serves to keep out intruders and to protect the rare and exotic plants that grow within.

The ground is thick with weeds and moss, and the air is heavy with the aroma of herbs and spices. The plants in the garden are a mishmash of medicinal and poisonous varieties, carefully tended to by someone. There are rows of medicinal herbs such as lavender, basil, and chamomile, as well as deadly nightshade, mandrake root, and henbane.

In the center of the garden is a large, ancient oak tree, its branches gnarled and twisted. The tree is said to be enchanted, and is the source of much of the witch's power. It is said that if you are brave enough to pluck a leaf from the tree, you will be granted a wish. But be warned, you get the feeling something is fiercely protective of  garden and will not hesitate to dispose anyone who tries to harm it.

Overall, the  garden is a mysterious and dangerous place, filled with secrets and magic. It is a place to be respected and feared, but also one of great power and potential.

The mysterious vine door prevents you from entering the hut, maybe the piercing green eyed cat can help you enter, you think to yourself.

Nero gazes upon you with his piercing green eyes, smirking.

* * *

>e
forest
You are standing in a dense forest, surrounded by tall trees and thick underbrush. It's hard to see more than a few feet in any direction. You have no idea how you ended up here, but you know you need to find your way out.

>n
mountain peak
You climb to the top of a mountain peak, where you have a breathtaking view of the surrounding landscape. You can see for miles in every direction, but unfortunately you don't recognize any of it. You'll need to find your way down and continue searching for a way out of the woods.

* * *

Lost in the Woods
Escape the Woods by Goran Filini?
Release 1 / Serial number 230109 / Inform 7 v10.1.2 / D

forest
You are in a dense forest, surrounded by tall trees and thick underbrush. It's hard to see more than a few feet in any direction. The trees are tall and their leaves rustle softly in the breeze. You can hear the distant sound of a stream nearby. The air is fresh and cool, and the ground is soft beneath you. It looks like you are alone in the forest.

What is your name?

>Bravo
That's not a verb I recognise.

What is your name?

* * *

Lost in the Woods
Escape the Woods by Goran Filini?
Release 1 / Serial number 230109 / Inform 7 v10.1.2 / D

forest
You are in a dense forest, surrounded by tall trees and thick underbrush. It's hard to see more than a few feet in any direction. The trees are tall and their leaves rustle softly in the breeze. You can hear the distant sound of a stream nearby. The air is fresh and cool, and the ground is soft beneath you. It looks like you are alone in the forest.

What is your name?

>Medeos
You wake up feeling dizzy. You try to get a grasp of your surroundings

 You are in a dense forest, surrounded by tall trees and thick underbrush. It's hard to see more than a few feet in any direction. You have no idea how you ended up here, but you know you need to find your way out. The trees are tall and their leaves rustle softly in the breeze. You can hear the distant sound of a stream nearby. The air is fresh and cool, and the ground is soft beneath you. It looks like you are alone in the forest.

* * *

>w
(first opening the mysterious vine door)

>w
(first opening the mysterious vine door)
It seems to be locked.

>w
(first opening the mysterious vine door)
It seems to be locked.

* * *

Lost in the Woods
Escape the Woods by Goran Filini?
Release 1 / Serial number 230109 / Inform 7 v10.1.2 / D

forest
You are in a dense forest, surrounded by tall trees and thick underbrush. It's hard to see more than a few feet in any direction. The trees are tall and their leaves rustle softly in the breeze. You can hear the distant sound of a stream nearby. The air is fresh and cool, and the ground is soft beneath you. It looks like you are alone in the forest.

What is your name?

>Medros
You wake up feeling dizzy. You try to get a grasp of your surroundings

 You are in a dense forest, surrounded by tall trees and thick underbrush. It's hard to see more than a few feet in any direction. You have no idea how you ended up here, but you know you need to find your way out. The trees are tall and their leaves rustle softly in the breeze. You can hear the distant sound of a stream nearby. The air is fresh and cool, and the ground is soft beneath you. It looks like you are alone in the forest.

>e
You push your way through a thicket of trees and underbrush, scratching your arms and legs on the rough branches. You hear rustling in the bushes and turn to see a pair of glowing eyes staring back at you. You're not sure what kind of animal it is, but you don't want to stick around to find out.

>w
garden
The garden is a small, overgrown patch of land located in front of the  hut. The garden is surrounded by a high, wooden fence, topped with barbed wire and warning signs. The fence serves to keep out intruders and to protect the rare and exotic plants that grow within.

The ground is thick with weeds and moss, and the air is heavy with the aroma of herbs and spices. The plants in the garden are a mishmash of medicinal and poisonous varieties, carefully tended to by someone. There are rows of medicinal herbs such as lavender, basil, and chamomile, as well as deadly nightshade, mandrake root, and henbane.

In the center of the garden is a large, ancient oak tree, its branches gnarled and twisted. The tree is said to be enchanted, and is the source of much of the witch's power. It is said that if you are brave enough to pluck a leaf from the tree, you will be granted a wish. But be warned, you get the feeling something is fiercely protective of  garden and will not hesitate to dispose anyone who tries to harm it.

Overall, the  garden is a mysterious and dangerous place, filled with secrets and magic. It is a place to be respected and feared, but also one of great power and potential.

The mysterious vine door prevents you from entering the hut, maybe the piercing green eyed cat can help you enter, you think to yourself.

Nero gazes upon you with his piercing green eyes, smirking.

>Talk to Nero
Medros: Who are you? How did you get in here?

 Nero: I am Nero, a magical feline with the ability to teleport. I have been watching you for some time. The witch wants to keep an eye out on you.

(nero laughs smirkly)Medros: I'm just trying to get to the hut to find some supplies, I didn't know this was witches, but there's a vine door blocking my way. Do you know how I can get through it?

Nero: Ah,  your first test is the vine door. It can only be unlocked with a special flower. But this flower does not grow in the garden. It can only be found on the mountain peak, high above the clouds.

Nero: Oh and another thing, I will be your guide for this trial, if you ever fill stuck just ask me "What now?"

>e
forest
You are standing in a dense forest, surrounded by tall trees and thick underbrush. It's hard to see more than a few feet in any direction. You have no idea how you ended up here, but you know you need to find your way out.

>s
ravine
You make your way down into a deep ravine, where you find a babbling brook running through the bottom. The water looks clear and cool, and you're tempted to take a drink. You notice a small cave on the other side of the ravine, which might be worth exploring.

The babbling brook runs through the bottom of the ravine, its clear, cool water inviting you to take a drink. You see small fish swimming through the water and hear the soothing sound of the flowing stream.

You can see a Female Otter here.

The female otter swims up to you and looks at you with curious eyes. She seems to be trying to communicate something to you, and you get the feeling that she wants you to follow her.

>follow female otter
By follow the otter You find an abandoned camp.

The Abandoned Camp is a desolate and eerie place, filled with the ghosts of the past. The camp consists of several dilapidated tents, their fabric torn and faded by the harsh elements. A few rickety wooden crates are scattered around the camp, their contents long since looted by scavengers. A campfire sits in the center of the camp, its ashes cold and lifeless. The only sounds are the howling wind and the creaking of the tents in the gusts.

As you explore the camp, you can't help but feel a sense of sadness and despair. It's clear that the former occupants of the camp were struggling to survive, and their fate remains a mystery. You wonder what brought them to this isolated and inhospitable place, and what ultimately caused them to abandon it. Despite the feeling of foreboding that hangs in the air, you can't shake the sense that there must be something of value hidden in the camp, waiting to be discovered.

 As you search through the abandoned camp following the otter, you notice a coiled alpine rope lying next to one of the rickety wooden crates. The rope appears to be in good condition, despite being left out in the elements for who knows how long. You wonder if it might come in handy during your exploration of the ravine.

As you finish your search, the female otter disappears into the brook, her dark fur blending in with the water as she swims away. You feel thankful, not being sure why did she help yout out.

>n
forest
You are standing in a dense forest, surrounded by tall trees and thick underbrush. It's hard to see more than a few feet in any direction. You have no idea how you ended up here, but you know you need to find your way out.

>s
ravine
You make your way down into a deep ravine, where you find a babbling brook running through the bottom. The water looks clear and cool, and you're tempted to take a drink. You notice a small cave on the other side of the ravine, which might be worth exploring.

The babbling brook runs through the bottom of the ravine, its clear, cool water inviting you to take a drink. You see small fish swimming through the water and hear the soothing sound of the flowing stream.

There is also an abandoned camp that you found earlier

>examine abandoned camp
The Abandoned Camp is a desolate and eerie place, filled with the ghosts of the past. The camp consists of several dilapidated tents, their fabric torn and faded by the harsh elements. A few rickety wooden crates are scattered around the camp, their contents long since looted by scavengers. A campfire sits in the center of the camp, its ashes cold and lifeless. The only sounds are the howling wind and the creaking of the tents in the gusts.

As you explore the camp, you can't help but feel a sense of sadness and despair. It's clear that the former occupants of the camp were struggling to survive, and their fate remains a mystery. You wonder what brought them to this isolated and inhospitable place, and what ultimately caused them to abandon it.

>n
forest
You are standing in a dense forest, surrounded by tall trees and thick underbrush. It's hard to see more than a few feet in any direction. You have no idea how you ended up here, but you know you need to find your way out.

>n
The cliff rises up before you, its rocky face sheer and imposing. It looks impossible to scale without proper equipment. Luckily you got the alpine rope from the ravine. You throw it up, like magic the rope extends to the farthest cliff and attaches itself. This rope is no ordinary rope, as you stand in awe as the rope is tightly secured, this must be witches work you think to yourself before gripping the rope and starting the mounmental climb

You can feel the sweat dripping down your face as you pull yourself up the mountain, the rough rock face scraping against your fingertips. Your muscles are burning with the effort of hauling yourself up, inch by inch. You glance down at the rope that anchors you to the mountain, a thin lifeline in this vast expanse of stone and ice.

The wind howls around you, whipping your hair into your face and biting through your layers of clothing. You clench your jaw and keep climbing, determined to reach the peak that beckons above you.

Every step is a struggle, your legs shaking with the effort of supporting your weight on the narrow ledges and handholds. But you don't give up, even when your hands are numb with cold and your breath comes in ragged gasps.

At last, you reach the top and collapse onto the snowy summit, your chest heaving with the exertion of the climb. It's a feeling of exhilaration and exhaustion all at once, the sense of accomplishment washing over you as you bask in the glory of the view.

But as you look out at the dizzying expanse below, you know that the struggle to reach this peak was worth it, and you can't wait to tackle the next challenge that comes your way.

mountain peak
This is the top of a mountain peak, where you have a breathtaking view of the surrounding landscape.  The golden sunset paints the sky in a dazzling array of orange, pink, and yellow hues, casting a warm glow over the landscape. As the sun dips below the horizon, the colors intensify, creating a breathtaking spectacle that fills the sky with a riot of color. You can see for miles in every direction, but unfortunately you don't recognize any of it. What worries you is that you don't see the flower which Nero mention.

What you do see however is the cherry blossom tree that stands tall in the middle of the mountain peak with all it's beauty, you might want to check it out.

>pick cherry
(the Cherry Blossom Tree)
That's hardly portable.

>examine cherry
(the Cherry Blossom Tree)
The cherry blossom tree stands tall on the mountain peak, its branches heavy with delicate pink flowers. The petals are a blur of color against the bright blue sky, each one a perfect, fragrant masterpiece. The breeze stirs the branches, sending a shower of petals swirling around you like confetti.

The cherries themselves are small and round, their skin a glossy red that seems to glow in the sunlight. You can't resist reaching out to pluck one from the branch, the juice bursting against your tongue as you bite into its sweet, tender flesh.

The scent of the cherry blossoms is intoxicating, filling the air with a heady aroma that is at once floral and fruity. You close your eyes and take a deep breath, feeling the stress of the world melting away as you bask in the beauty of the tree.

As you stand there, surrounded by the cherry blossom tree's graceful branches and fragrant flowers, you can't help but feel a sense of peace and contentment wash over you. It's a moment of pure, unadulterated joy, one that you know you'll always treasure.

In the Cherry Blossom Tree is Beautiful Cherry.

>pick beautiful cherry
Taken.

>eat beautiful cherry
As you bite into the cherry, you feel a burst of sweetness flood your mouth. The juice is like ambrosia, nourishing and revitalizing you with each swallow. You feel a sense of strength and energy coursing through your veins, as if you could climb the mountain a hundred times and not feel the slightest bit of fatigue.

You finish the cherry and toss the pit aside, feeling a sense of renewal wash over you. You are ready to tackle the mountain again, to climb to the peak and conquer the challenges that lie ahead. The cherry has given you the strength and determination to succeed, and you know that you can do anything you set your mind to.

You toss the cherry pit aside, watching as it tumbles through the air and lands on the ground. But as you look on in amazement, something strange begins to happen. The wind picks up, blowing a shower of cherry blossom petals from the tree above. The petals twist and twirl around the cherry pit, forming a swirling mass of white and black. And then, in a matter of seconds, a beautiful orchid blooms from the cherry pit, its white petals stark against the dark, velvety center.

You stare in awe at the orchid, marveling at the way it appeared out of nowhere. The flower seems to pulsate with a magical energy, as if it were alive and breathing. You can't help but feel a sense of wonder and amazement at the sight, knowing that you have witnessed something truly special and extraordinary. The orchid is a symbol of beauty and magic, a reminder of the wonders that can be found in the world around us.

>pick magical white orchid
As you pluck the orchid from its stem, the sky suddenly grows dark, as if the very act of picking the flower has brought on nightfall. You look up at the sky in surprise, watching as the stars begin to twinkle above you. The moon rises, full and round, casting a pale glow over the landscape.

But even though the night is dark, you are not afraid. You have the orchid, and the flower seems to pulse with a magical energy, providing a soft and gentle light that illuminates your surroundings. The petals of the orchid glow softly, casting a warm and comforting glow that helps you see your way through the darkness. You feel a sense of wonder and amazement as you walk, marveling at the way the orchid seems to light your path with its magic. The moon and the stars provide good visibility, and you feel a sense of peace and contentment as you make your way through the night.

>s
forest
You are standing in a dense forest, surrounded by tall trees and thick underbrush. It's hard to see more than a few feet in any direction. You have no idea how you ended up here, but you know you need to find your way out.

>w
garden
The garden is a small, overgrown patch of land located in front of the  hut. The garden is surrounded by a high, wooden fence, topped with barbed wire and warning signs. The fence serves to keep out intruders and to protect the rare and exotic plants that grow within.

The ground is thick with weeds and moss, and the air is heavy with the aroma of herbs and spices. The plants in the garden are a mishmash of medicinal and poisonous varieties, carefully tended to by someone. There are rows of medicinal herbs such as lavender, basil, and chamomile, as well as deadly nightshade, mandrake root, and henbane.

In the center of the garden is a large, ancient oak tree, its branches gnarled and twisted. The tree is said to be enchanted, and is the source of much of the witch's power. It is said that if you are brave enough to pluck a leaf from the tree, you will be granted a wish. But be warned, you get the feeling something is fiercely protective of  garden and will not hesitate to dispose anyone who tries to harm it.

Overall, the  garden is a mysterious and dangerous place, filled with secrets and magic. It is a place to be respected and feared, but also one of great power and potential.

The mysterious vine door prevents you from entering the hut, maybe the piercing green eyed cat can help you enter, you think to yourself.

Nero gazes upon you with his piercing green eyes, smirking.

>talk to Nero
You did well by finding magical white orchid, now you can proceed to the hut, the next challenge awaits for you there

>w
(first opening the mysterious vine door)
As you approach the massive vine door, the thick tendrils coiling and writhing as if alive, you can't help but feel a sense of mystery and danger emanating from it. The vines are so dense that you can't see what lies beyond them, adding to the sense of uncertainty.

You reach out tentatively to touch the vines, and they seem to pulse and writhe under your fingers. It's as if they are trying to communicate something to you, but you can't decipher their message.

Despite the eerie feeling that surrounds the vine door, you can't shake the feeling that there is something important waiting for you on the other side. You pull out the magical white orchid flower that you obtained earlier and hold it up to the vines.

To your surprise, the vines immediately calm and stop writhing. The dense foliage begins to part, revealing a small opening that you can just fit through. You take a deep breath and step through the opening, feeling a sense of anticipation and excitement wash over you as you wonder what lies ahead.

It seems to be locked.

>unlock
What do you want to unlock?

>vine door
What do you want to unlock the mysterious vine door with?

>white orchid
You unlock the mysterious vine door.

>w
(first opening the mysterious vine door)
As you approach the massive vine door, the thick tendrils coiling and writhing as if alive, you can't help but feel a sense of mystery and danger emanating from it. The vines are so dense that you can't see what lies beyond them, adding to the sense of uncertainty.

You reach out tentatively to touch the vines, and they seem to pulse and writhe under your fingers. It's as if they are trying to communicate something to you, but you can't decipher their message.

Despite the eerie feeling that surrounds the vine door, you can't shake the feeling that there is something important waiting for you on the other side. You pull out the magical white orchid flower that you obtained earlier and hold it up to the vines.

To your surprise, the vines immediately calm and stop writhing. The dense foliage begins to part, revealing a small opening that you can just fit through. You take a deep breath and step through the opening, feeling a sense of anticipation and excitement wash over you as you wonder what lies ahead.

hut
You can see a lot of mystical stuff and alchemy stuff all around. There is also a fireplace

The mysterious vine door prevents you from entering the hut, maybe the piercing green eyed cat can help you enter, you think to yourself.

Cauldron is on top of the fireplace. It is boiling something.

* * *

>w
garden
The garden is a small, overgrown patch of land located in front of the  hut. The garden is surrounded by a high, wooden fence, topped with barbed wire and warning signs. The fence serves to keep out intruders and to protect the rare and exotic plants that grow within.

The ground is thick with weeds and moss, and the air is heavy with the aroma of herbs and spices. The plants in the garden are a mishmash of medicinal and poisonous varieties, carefully tended to by someone. There are rows of medicinal herbs such as lavender, basil, and chamomile, as well as deadly nightshade, mandrake root, and henbane.

In the center of the garden is a large, ancient oak tree, its branches gnarled and twisted. The tree is said to be enchanted, and is the source of much of the witch's power. It is said that if you are brave enough to pluck a leaf from the tree, you will be granted a wish. But be warned, you get the feeling something is fiercely protective of  garden and will not hesitate to dispose anyone who tries to harm it.

Overall, the  garden is a mysterious and dangerous place, filled with secrets and magic. It is a place to be respected and feared, but also one of great power and potential.

The mysterious vine door prevents you from entering the hut, maybe the piercing green eyed cat can help you enter, you think to yourself.

Nero gazes upon you with his piercing green eyes, smirking.

>thicket
That's not a verb I recognise.

I beg your pardon?

I beg your pardon?

* * *

>Medros
You wake up feeling dizzy. You try to get a grasp of your surroundings

 You are in a dense forest, surrounded by tall trees and thick underbrush. It's hard to see more than a few feet in any direction. You have no idea how you ended up here, but you know you need to find your way out. The trees are tall and their leaves rustle softly in the breeze. You can hear the distant sound of a stream nearby. The air is fresh and cool, and the ground is soft beneath you. It looks like you are alone in the forest.

>meditate
You meditate blisfully for a while

* * *

>Medros
You wake up feeling dizzy. You try to get a grasp of your surroundings

 You are in a dense forest, surrounded by tall trees and thick underbrush. It's hard to see more than a few feet in any direction. You have no idea how you ended up here, but you know you need to find your way out. The trees are tall and their leaves rustle softly in the breeze. You can hear the distant sound of a stream nearby. The air is fresh and cool, and the ground is soft beneath you. It looks like you are alone in the forest.

>read
There is nothing to read here...

* * *

>Medros
You wake up feeling dizzy. You try to get a grasp of your surroundings

 You are in a dense forest, surrounded by tall trees and thick underbrush. It's hard to see more than a few feet in any direction. You have no idea how you ended up here, but you know you need to find your way out. The trees are tall and their leaves rustle softly in the breeze. You can hear the distant sound of a stream nearby. The air is fresh and cool, and the ground is soft beneath you. It looks like you are alone in the forest.

>s
ravine
You make your way down into a deep ravine, where you find a babbling brook running through the bottom. The water looks clear and cool, and you're tempted to take a drink. You notice a small cave on the other side of the ravine, which might be worth exploring.

The babbling brook runs through the bottom of the ravine, its clear, cool water inviting you to take a drink. You see small fish swimming through the water and hear the soothing sound of the flowing stream. You can also see a dark cave down from ravine, but it gives you an ominous feeling

You can see a Female Otter here.

The female otter swims up to you and looks at you with curious eyes. She seems to be trying to communicate something to you, and you get the feeling that she wants you to follow her.

>e
You can't go that way.

>follow otter
By follow the otter You find an abandoned camp.

The Abandoned Camp is a desolate and eerie place, filled with the ghosts of the past. The camp consists of several dilapidated tents, their fabric torn and faded by the harsh elements. A few rickety wooden crates are scattered around the camp, their contents long since looted by scavengers. A campfire sits in the center of the camp, its ashes cold and lifeless. The only sounds are the howling wind and the creaking of the tents in the gusts.

As you explore the camp, you can't help but feel a sense of sadness and despair. It's clear that the former occupants of the camp were struggling to survive, and their fate remains a mystery. You wonder what brought them to this isolated and inhospitable place, and what ultimately caused them to abandon it. Despite the feeling of foreboding that hangs in the air, you can't shake the sense that there must be something of value hidden in the camp, waiting to be discovered.

 As you search through the abandoned camp following the otter, you notice a coiled alpine rope lying next to one of the rickety wooden crates. The rope appears to be in good condition, despite being left out in the elements for who knows how long. You wonder if it might come in handy during your exploration of the ravine.

As you finish your search, the female otter disappears into the brook, her dark fur blending in with the water as she swims away. You feel thankful, not being sure why did she help yout out.

>n
forest
You are standing in a dense forest, surrounded by tall trees and thick underbrush. It's hard to see more than a few feet in any direction. You have no idea how you ended up here, but you know you need to find your way out.

>n
The cliff rises up before you, its rocky face sheer and imposing. It looks impossible to scale without proper equipment. Luckily you got the alpine rope from the ravine. You throw it up, like magic the rope extends to the farthest cliff and attaches itself. This rope is no ordinary rope, as you stand in awe as the rope is tightly secured, this must be witches work you think to yourself before gripping the rope and starting the mounmental climb

You can feel the sweat dripping down your face as you pull yourself up the mountain, the rough rock face scraping against your fingertips. Your muscles are burning with the effort of hauling yourself up, inch by inch. You glance down at the rope that anchors you to the mountain, a thin lifeline in this vast expanse of stone and ice.

The wind howls around you, whipping your hair into your face and biting through your layers of clothing. You clench your jaw and keep climbing, determined to reach the peak that beckons above you.

Every step is a struggle, your legs shaking with the effort of supporting your weight on the narrow ledges and handholds. But you don't give up, even when your hands are numb with cold and your breath comes in ragged gasps.

At last, you reach the top and collapse onto the snowy summit, your chest heaving with the exertion of the climb. It's a feeling of exhilaration and exhaustion all at once, the sense of accomplishment washing over you as you bask in the glory of the view.

But as you look out at the dizzying expanse below, you know that the struggle to reach this peak was worth it, and you can't wait to tackle the next challenge that comes your way.

mountain peak
This is the top of a mountain peak, where you have a breathtaking view of the surrounding landscape.  The golden sunset paints the sky in a dazzling array of orange, pink, and yellow hues, casting a warm glow over the landscape. As the sun dips below the horizon, the colors intensify, creating a breathtaking spectacle that fills the sky with a riot of color. You can see for miles in every direction, but unfortunately you don't recognize any of it. You'll need to find your way down and continue searching for a way out of the woods.

The cherry blossom tree stands tall in the middle of the mountain peak with all it's beauty, you might want to check it out.

>pick beautiful cherry
Taken.

* * *

>follow otter
By follow the otter You find an abandoned camp.

The Abandoned Camp is a desolate and eerie place, filled with the ghosts of the past. The camp consists of several dilapidated tents, their fabric torn and faded by the harsh elements. A few rickety wooden crates are scattered around the camp, their contents long since looted by scavengers. A campfire sits in the center of the camp, its ashes cold and lifeless. The only sounds are the howling wind and the creaking of the tents in the gusts.

As you explore the camp, you can't help but feel a sense of sadness and despair. It's clear that the former occupants of the camp were struggling to survive, and their fate remains a mystery. You wonder what brought them to this isolated and inhospitable place, and what ultimately caused them to abandon it. Despite the feeling of foreboding that hangs in the air, you can't shake the sense that there must be something of value hidden in the camp, waiting to be discovered.

 As you search through the abandoned camp following the otter, you notice a coiled alpine rope lying next to one of the rickety wooden crates. The rope appears to be in good condition, despite being left out in the elements for who knows how long. You wonder if it might come in handy during your exploration of the ravine.

As you finish your search, the female otter disappears into the brook, her dark fur blending in with the water as she swims away. You feel thankful, not being sure why did she help yout out.

>i
You are carrying:
  Alpine rope

>n
forest
You are in a dense forest, surrounded by tall trees and thick underbrush. It's hard to see more than a few feet in any direction. The trees are tall and their leaves rustle softly in the breeze. You can hear the distant sound of a stream nearby. The air is fresh and cool, and the ground is soft beneath you. It looks like you are alone in the forest.

>n
The cliff rises up before you, its rocky face sheer and imposing. It looks impossible to scale without proper equipment. Luckily you got the alpine rope from the ravine. You throw it up, like magic the rope extends to the farthest cliff and attaches itself. This rope is no ordinary rope, as you stand in awe as the rope is tightly secured, this must be witches work you think to yourself before gripping the rope and starting the mounmental climb

You can feel the sweat dripping down your face as you pull yourself up the mountain, the rough rock face scraping against your fingertips. Your muscles are burning with the effort of hauling yourself up, inch by inch. You glance down at the rope that anchors you to the mountain, a thin lifeline in this vast expanse of stone and ice.

The wind howls around you, whipping your hair into your face and biting through your layers of clothing. You clench your jaw and keep climbing, determined to reach the peak that beckons above you.

Every step is a struggle, your legs shaking with the effort of supporting your weight on the narrow ledges and handholds. But you don't give up, even when your hands are numb with cold and your breath comes in ragged gasps.

At last, you reach the top and collapse onto the snowy summit, your chest heaving with the exertion of the climb. It's a feeling of exhilaration and exhaustion all at once, the sense of accomplishment washing over you as you bask in the glory of the view.

But as you look out at the dizzying expanse below, you know that the struggle to reach this peak was worth it, and you can't wait to tackle the next challenge that comes your way.

mountain peak
This is the top of a mountain peak, where you have a breathtaking view of the surrounding landscape.  The golden sunset paints the sky in a dazzling array of orange, pink, and yellow hues, casting a warm glow over the landscape. As the sun dips below the horizon, the colors intensify, creating a breathtaking spectacle that fills the sky with a riot of color. You can see for miles in every direction, but unfortunately you don't recognize any of it. You'll need to find your way down and continue searching for a way out of the woods.

The cherry blossom tree stands tall in the middle of the mountain peak with all it's beauty, you might want to check it out.

>pick cherry
(the Cherry Blossom Tree)
That's hardly portable.

>pick beautiful cherry
Taken.

>eat cherry
(Beautiful Cherry)
As you bite into the cherry, you feel a burst of sweetness flood your mouth. The juice is like ambrosia, nourishing and revitalizing you with each swallow. You feel a sense of strength and energy coursing through your veins, as if you could climb the mountain a hundred times and not feel the slightest bit of fatigue.

You finish the cherry and toss the pit aside, feeling a sense of renewal wash over you. You are ready to tackle the mountain again, to climb to the peak and conquer the challenges that lie ahead. The cherry has given you the strength and determination to succeed, and you know that you can do anything you set your mind to.

You toss the cherry pit aside, watching as it tumbles through the air and lands on the ground. But as you look on in amazement, something strange begins to happen. The wind picks up, blowing a shower of cherry blossom petals from the tree above. The petals twist and twirl around the cherry pit, forming a swirling mass of white and black. And then, in a matter of seconds, a beautiful orchid blooms from the cherry pit, its white petals stark against the dark, velvety center.

You stare in awe at the orchid, marveling at the way it appeared out of nowhere. The flower seems to pulsate with a magical energy, as if it were alive and breathing. You can't help but feel a sense of wonder and amazement at the sight, knowing that you have witnessed something truly special and extraordinary. The orchid is a symbol of beauty and magic, a reminder of the wonders that can be found in the world around us.

>pick orchid
As you pluck the orchid from its stem, the sky suddenly grows dark, as if the very act of picking the flower has brought on nightfall. You look up at the sky in surprise, watching as the stars begin to twinkle above you. The moon rises, full and round, casting a pale glow over the landscape.

But even though the night is dark, you are not afraid. You have the orchid, and the flower seems to pulse with a magical energy, providing a soft and gentle light that illuminates your surroundings. The petals of the orchid glow softly, casting a warm and comforting glow that helps you see your way through the darkness. You feel a sense of wonder and amazement as you walk, marveling at the way the orchid seems to light your path with its magic. The moon and the stars provide good visibility, and you feel a sense of peace and contentment as you make your way through the night.

>drop orchid
You really don't want to put this flower down, it may be the key to your escape

* * *

>pick cherry
(the Cherry Blossom Tree)
That's hardly portable.

>pick cherries
Taken.

>eat cherries
As you bite into the cherry, you feel a burst of sweetness flood your mouth. The juice is like ambrosia, nourishing and revitalizing you with each swallow. You feel a sense of strength and energy coursing through your veins, as if you could climb the mountain a hundred times and not feel the slightest bit of fatigue.

You finish the cherry and toss the pit aside, feeling a sense of renewal wash over you. You are ready to tackle the mountain again, to climb to the peak and conquer the challenges that lie ahead. The cherry has given you the strength and determination to succeed, and you know that you can do anything you set your mind to.

You toss the cherry pit aside, watching as it tumbles through the air and lands on the ground. But as you look on in amazement, something strange begins to happen. The wind picks up, blowing a shower of cherry blossom petals from the tree above. The petals twist and twirl around the cherry pit, forming a swirling mass of white and black. And then, in a matter of seconds, a beautiful orchid blooms from the cherry pit, its white petals stark against the dark, velvety center.

You stare in awe at the orchid, marveling at the way it appeared out of nowhere. The flower seems to pulsate with a magical energy, as if it were alive and breathing. You can't help but feel a sense of wonder and amazement at the sight, knowing that you have witnessed something truly special and extraordinary. The orchid is a symbol of beauty and magic, a reminder of the wonders that can be found in the world around us.

>pick magical white orchid
As you pluck the orchid from its stem, the sky suddenly grows dark, as if the very act of picking the flower has brought on nightfall. You look up at the sky in surprise, watching as the stars begin to twinkle above you. The moon rises, full and round, casting a pale glow over the landscape.

But even though the night is dark, you are not afraid. You have the orchid, and the flower seems to pulse with a magical energy, providing a soft and gentle light that illuminates your surroundings. The petals of the orchid glow softly, casting a warm and comforting glow that helps you see your way through the darkness. You feel a sense of wonder and amazement as you walk, marveling at the way the orchid seems to light your path with its magic. The moon and the stars provide good visibility, and you feel a sense of peace and contentment as you make your way through the night.

>s
forest
You are in a dense forest, surrounded by tall trees and thick underbrush. It's hard to see more than a few feet in any direction. The trees are tall and their leaves rustle softly in the breeze. You can hear the distant sound of a stream nearby. The air is fresh and cool, and the ground is soft beneath you. It looks like you are alone in the forest.

>w
garden
The garden is a small, overgrown patch of land located in front of the  hut. The garden is surrounded by a high, wooden fence, topped with barbed wire and warning signs. The fence serves to keep out intruders and to protect the rare and exotic plants that grow within.

The ground is thick with weeds and moss, and the air is heavy with the aroma of herbs and spices. The plants in the garden are a mishmash of medicinal and poisonous varieties, carefully tended to by someone. There are rows of medicinal herbs such as lavender, basil, and chamomile, as well as deadly nightshade, mandrake root, and henbane.

In the center of the garden is a large, ancient oak tree, its branches gnarled and twisted. The tree is said to be enchanted, and is the source of much of the witch's power. It is said that if you are brave enough to pluck a leaf from the tree, you will be granted a wish. But be warned, you get the feeling something is fiercely protective of  garden and will not hesitate to dispose anyone who tries to harm it.

Overall, the  garden is a mysterious and dangerous place, filled with secrets and magic. It is a place to be respected and feared, but also one of great power and potential.

The mysterious vine door stands at the entrance of the hut.

Nero gazes upon you with his piercing green eyes, smirking.

>talk to Nero
You did well by finding magical white orchid, now you can proceed to the hut, the next challenge awaits for you inside... fufufu

>w
(first opening the mysterious vine door)
As you approach the massive vine door, the thick tendrils coiling and writhing as if alive, you can't help but feel a sense of mystery and danger emanating from it. The vines are so dense that you can't see what lies beyond them, adding to the sense of uncertainty.

You reach out tentatively to touch the vines, and they seem to pulse and writhe under your fingers. It's as if they are trying to communicate something to you, but you can't decipher their message.

Despite the eerie feeling that surrounds the vine door, you can't shake the feeling that there is something important waiting for you on the other side. You pull out the magical white orchid flower that you obtained earlier and hold it up to the vines.

To your surprise, the vines immediately calm and stop writhing. The dense foliage begins to part, revealing a small opening that you can just fit through.

Before going to the other side of the door however, you are greeted by a stunning sight. The sun is rising over the horizon, casting a warm glow over the entire forest. The trees and plants in the garden and the whole forest seems to come alive, shining and shimmering in the morning light.

You stand there for a moment, marveling at the beauty of it all. It's as if the mysterious vine door was the key to unlocking a hidden world, full of magic and wonder.

You take a deep breath and step through the opening, feeling a sense of anticipation and excitement wash over you as you wonder what lies ahead.

hut
The hut is small and cozy, with thick stone walls that keep out the cold. A fire is crackling in the fireplace, and a large cauldron is boiling away on top of it, sending thick plumes of steam into the air. The smell of herbs and spices fills the room, and you can see a variety of strange and mystical objects scattered throughout the space. There are shelves lined with old leather-bound books, crystals and gemstones, and various alchemy equipment like beakers, flasks, and Bunsen burners. In the corner, there's a workbench covered in papers and diagrams, with a microscope and a set of delicate instruments. The hut feels like a place of magic and mystery, and you can't help but wonder what secrets it holds.

The mysterious vine door stands at the entrance of the hut.

In the middle of the room, there's a ladder that leads up to a trapdoor in the ceiling. It's unclear where the ladder might lead, but you can't help but wonder what secrets the hut holds.

Cauldron is on top of the fireplace. It is boiling something.

>w
You can't go that way.

>w
You can't go that way.

>look
hut
The hut is small and cozy, with thick stone walls that keep out the cold. A fire is crackling in the fireplace, and a large cauldron is boiling away on top of it, sending thick plumes of steam into the air. The smell of herbs and spices fills the room, and you can see a variety of strange and mystical objects scattered throughout the space. There are shelves lined with old leather-bound books, crystals and gemstones, and various alchemy equipment like beakers, flasks, and Bunsen burners. In the corner, there's a workbench covered in papers and diagrams, with a microscope and a set of delicate instruments. The hut feels like a place of magic and mystery, and you can't help but wonder what secrets it holds.

The mysterious vine door stands at the entrance of the hut.

In the middle of the room, there's a ladder that leads up to a trapdoor in the ceiling. It's unclear where the ladder might lead, but you can't help but wonder what secrets the hut holds.

Cauldron is on top of the fireplace. It is boiling something.

>climb ladder
Library
As you make your way over to the ladder, you notice that the trapdoor is heavy and requires some effort to open. But once you manage to lift it, you're greeted with the sight of a spacious and well-lit library. There are shelves upon shelves of books, ranging from ancient texts to modern novels. A ladder on wheels sits against one of the walls, allowing you to easily reach the higher shelves. A large desk sits in the center of the room, with a comfortable-looking armchair pulled up to it. Sunlight streams in through a skylight overhead, casting a warm glow over the space. It's clear that this is a place of learning and knowledge, and you feel a sense of excitement at the prospect of exploring all the books and secrets it holds.

You can see Solomon here.

>climb
What do you want to climb?

>ladder
You can't see any such thing.

>go down the ladder
I only understood you as far as wanting to go down.

>down
hut
The hut is small and cozy, with thick stone walls that keep out the cold. A fire is crackling in the fireplace, and a large cauldron is boiling away on top of it, sending thick plumes of steam into the air. The smell of herbs and spices fills the room, and you can see a variety of strange and mystical objects scattered throughout the space. There are shelves lined with old leather-bound books, crystals and gemstones, and various alchemy equipment like beakers, flasks, and Bunsen burners. In the corner, there's a workbench covered in papers and diagrams, with a microscope and a set of delicate instruments. The hut feels like a place of magic and mystery, and you can't help but wonder what secrets it holds.

The mysterious vine door stands at the entrance of the hut.

In the middle of the room, there's a ladder that leads up to a trapdoor in the ceiling. It's unclear where the ladder might lead, but you can't help but wonder what secrets the hut holds.

Cauldron is on top of the fireplace. It is boiling something.

I beg your pardon?

>look
hut
The hut is small and cozy, with thick stone walls that keep out the cold. A fire is crackling in the fireplace, and a large cauldron is boiling away on top of it, sending thick plumes of steam into the air. The smell of herbs and spices fills the room, and you can see a variety of strange and mystical objects scattered throughout the space. There are shelves lined with old leather-bound books, crystals and gemstones, and various alchemy equipment like beakers, flasks, and Bunsen burners. In the corner, there's a workbench covered in papers and diagrams, with a microscope and a set of delicate instruments. The hut feels like a place of magic and mystery, and you can't help but wonder what secrets it holds.

The mysterious vine door stands at the entrance of the hut.

In the middle of the room, there's a ladder that leads up to a trapdoor in the ceiling. It's unclear where the ladder might lead, but you can't help but wonder what secrets the hut holds.

Cauldron is on top of the fireplace. It is boiling something.

>up
test

* * *

>look
hut
The hut is small and cozy, with thick stone walls that keep out the cold. A fire is crackling in the fireplace, and a large cauldron is boiling away on top of it, sending thick plumes of steam into the air. The smell of herbs and spices fills the room, and you can see a variety of strange and mystical objects scattered throughout the space. There are shelves lined with old leather-bound books, crystals and gemstones, and various alchemy equipment like beakers, flasks, and Bunsen burners. In the corner, there's a workbench covered in papers and diagrams, with a microscope and a set of delicate instruments. The hut feels like a place of magic and mystery, and you can't help but wonder what secrets it holds.

The mysterious vine door stands at the entrance of the hut.

In the middle of the room, there's a ladder that leads up to a trapdoor in the ceiling. It's unclear where the ladder might lead, but you can't help but wonder what secrets the hut holds.

Cauldron is on top of the fireplace. It is boiling something.

>up
Library
As you make your way over to the ladder, you notice that the trapdoor is heavy and requires some effort to open. But once you manage to lift it, you're greeted with the sight of a spacious and well-lit library. There are shelves upon shelves of books, ranging from ancient texts to modern novels. A ladder on wheels sits against one of the walls, allowing you to easily reach the higher shelves. A large desk sits in the center of the room, with a comfortable-looking armchair pulled up to it. Sunlight streams in through a skylight overhead, casting a warm glow over the space. It's clear that this is a place of learning and knowledge, and you feel a sense of excitement at the prospect of exploring all the books and secrets it holds.

You can see Solomon here.

>down
hut
The hut is small and cozy, with thick stone walls that keep out the cold. A fire is crackling in the fireplace, and a large cauldron is boiling away on top of it, sending thick plumes of steam into the air. The smell of herbs and spices fills the room, and you can see a variety of strange and mystical objects scattered throughout the space. There are shelves lined with old leather-bound books, crystals and gemstones, and various alchemy equipment like beakers, flasks, and Bunsen burners. In the corner, there's a workbench covered in papers and diagrams, with a microscope and a set of delicate instruments. The hut feels like a place of magic and mystery, and you can't help but wonder what secrets it holds.

The mysterious vine door stands at the entrance of the hut.

In the middle of the room, there's a ladder that leads up to a trapdoor in the ceiling. It's unclear where the ladder might lead, but you can't help but wonder what secrets the hut holds.

Cauldron is on top of the fireplace. It is boiling something.

>up
Library
As you make your way over to the ladder, you notice that the trapdoor is heavy and requires some effort to open. But once you manage to lift it, you're greeted with the sight of a spacious and well-lit library. There are shelves upon shelves of books, ranging from ancient texts to modern novels. A ladder on wheels sits against one of the walls, allowing you to easily reach the higher shelves. A large desk sits in the center of the room, with a comfortable-looking armchair pulled up to it. Sunlight streams in through a skylight overhead, casting a warm glow over the space. It's clear that this is a place of learning and knowledge, and you feel a sense of excitement at the prospect of exploring all the books and secrets it holds.

You can see Solomon here.

* * *

>climb ladder
Library
As you make your way over to the ladder, you notice that the trapdoor is heavy and requires some effort to open. But once you manage to lift it, you're greeted with the sight of a spacious and well-lit library. There are shelves upon shelves of books, ranging from ancient texts to modern novels. A ladder on wheels sits against one of the walls, allowing you to easily reach the higher shelves. A large desk sits in the center of the room, with a comfortable-looking armchair pulled up to it. Sunlight streams in through a skylight overhead, casting a warm glow over the space. It's clear that this is a place of learning and knowledge, and you feel a sense of excitement at the prospect of exploring all the books and secrets it holds.

You can see Solomon here.

>climb ladder
You can't see any such thing.

>go down
hut
The hut is small and cozy, with thick stone walls that keep out the cold. A fire is crackling in the fireplace, and a large cauldron is boiling away on top of it, sending thick plumes of steam into the air. The smell of herbs and spices fills the room, and you can see a variety of strange and mystical objects scattered throughout the space. There are shelves lined with old leather-bound books, crystals and gemstones, and various alchemy equipment like beakers, flasks, and Bunsen burners. In the corner, there's a workbench covered in papers and diagrams, with a microscope and a set of delicate instruments. The hut feels like a place of magic and mystery, and you can't help but wonder what secrets it holds.

The mysterious vine door stands at the entrance of the hut.

In the middle of the room, there's a ladder that leads up to a trapdoor in the ceiling. It's unclear where the ladder might lead, but you can't help but wonder what secrets the hut holds.

Cauldron is on top of the fireplace. It is boiling something.

* * *

>n
forest
You are in a dense forest, surrounded by tall trees and thick underbrush. It's hard to see more than a few feet in any direction. The trees are tall and their leaves rustle softly in the breeze. You can hear the distant sound of a stream nearby. The air is fresh and cool, and the ground is soft beneath you. It looks like you are alone in the forest.

* * *

>pick cherries
Taken.

* * *

>pick flower
You can't see any such thing.

>pick orchid
As you pluck the orchid from its stem, the sky suddenly grows dark, as if the very act of picking the flower has brought on nightfall. You look up at the sky in surprise, watching as the stars begin to twinkle above you. The moon rises, full and round, casting a pale glow over the landscape.

But even though the night is dark, you are not afraid. You have the orchid, and the flower seems to pulse with a magical energy, providing a soft and gentle light that illuminates your surroundings. The petals of the orchid glow softly, casting a warm and comforting glow that helps you see your way through the darkness. You feel a sense of wonder and amazement as you walk, marveling at the way the orchid seems to light your path with its magic. The moon and the stars provide good visibility, and you feel a sense of peace and contentment as you make your way through the night.

>s
forest
You are in a dense forest, surrounded by tall trees and thick underbrush. It's hard to see more than a few feet in any direction. The trees are tall and their leaves rustle softly in the breeze. You can hear the distant sound of a stream nearby. The air is fresh and cool, and the ground is soft beneath you. It looks like you are alone in the forest.

>s
ravine
You make your way down into a deep ravine, where you find a babbling brook running through the bottom. The water looks clear and cool, and you're tempted to take a drink. You notice a small cave on the other side of the ravine, which might be worth exploring.

The babbling brook runs through the bottom of the ravine, its clear, cool water inviting you to take a drink. You see small fish swimming through the water and hear the soothing sound of the flowing stream.

There is also an abandoned camp that you found earlier

>n
forest
You are in a dense forest, surrounded by tall trees and thick underbrush. It's hard to see more than a few feet in any direction. The trees are tall and their leaves rustle softly in the breeze. You can hear the distant sound of a stream nearby. The air is fresh and cool, and the ground is soft beneath you. It looks like you are alone in the forest.

* * *

I beg your pardon?

>w
(first opening the mysterious vine door)
As you approach the massive vine door, the thick tendrils coiling and writhing as if alive, you can't help but feel a sense of mystery and danger emanating from it. The vines are so dense that you can't see what lies beyond them, adding to the sense of uncertainty.

You reach out tentatively to touch the vines, and they seem to pulse and writhe under your fingers. It's as if they are trying to communicate something to you, but you can't decipher their message.

Despite the eerie feeling that surrounds the vine door, you can't shake the feeling that there is something important waiting for you on the other side. You pull out the magical white orchid flower that you obtained earlier and hold it up to the vines.

To your surprise, the vines immediately calm and stop writhing. The dense foliage begins to part, revealing a small opening that you can just fit through.

Before going to the other side of the door however, you are greeted by a stunning sight. The sun is rising over the horizon, casting a warm glow over the entire forest. The trees and plants in the garden and the whole forest seems to come alive, shining and shimmering in the morning light.

You stand there for a moment, marveling at the beauty of it all. It's as if the mysterious vine door was the key to unlocking a hidden world, full of magic and wonder.

You take a deep breath and step through the opening, feeling a sense of anticipation and excitement wash over you as you wonder what lies ahead.

hut
The hut is small and cozy, with thick stone walls that keep out the cold. A fire is crackling in the fireplace, and a large cauldron is boiling away on top of it, sending thick plumes of steam into the air. The smell of herbs and spices fills the room, and you can see a variety of strange and mystical objects scattered throughout the space. There are shelves lined with old leather-bound books, crystals and gemstones, and various alchemy equipment like beakers, flasks, and Bunsen burners. In the corner, there's a workbench covered in papers and diagrams, with a microscope and a set of delicate instruments. The hut feels like a place of magic and mystery, and you can't help but wonder what secrets it holds.

The mysterious vine door stands at the entrance of the hut.

In the middle of the room, there's a ladder that leads up to a trapdoor in the ceiling. It's unclear where the ladder might lead, but you can't help but wonder what secrets the hut holds.

Cauldron is on top of the fireplace. It is boiling something.

* * *

>w
(first opening the mysterious vine door)
As you approach the massive vine door, the thick tendrils coiling and writhing as if alive, you can't help but feel a sense of mystery and danger emanating from it. The vines are so dense that you can't see what lies beyond them, adding to the sense of uncertainty.

You reach out tentatively to touch the vines, and they seem to pulse and writhe under your fingers. It's as if they are trying to communicate something to you, but you can't decipher their message.

Despite the eerie feeling that surrounds the vine door, you can't shake the feeling that there is something important waiting for you on the other side. You pull out the magical white orchid flower that you obtained earlier and hold it up to the vines.

To your surprise, the vines immediately calm and stop writhing. The dense foliage begins to part, revealing a small opening that you can just fit through.

Before going to the other side of the door however, you are greeted by a stunning sight. The sun is rising over the horizon, casting a warm glow over the entire forest. The trees and plants in the garden and the whole forest seems to come alive, shining and shimmering in the morning light.

You stand there for a moment, marveling at the beauty of it all. It's as if the mysterious vine door was the key to unlocking a hidden world, full of magic and wonder.

You take a deep breath and step through the opening, feeling a sense of anticipation and excitement wash over you as you wonder what lies ahead.

hut
The hut is small and cozy, with thick stone walls that keep out the cold. A fire is crackling in the fireplace, and a large cauldron is boiling away on top of it, sending thick plumes of steam into the air. The smell of herbs and spices fills the room, and you can see a variety of strange and mystical objects scattered throughout the space. There are shelves lined with old leather-bound books, crystals and gemstones, and various alchemy equipment like beakers, flasks, and Bunsen burners. In the corner, there's a workbench covered in papers and diagrams, with a microscope and a set of delicate instruments. The hut feels like a place of magic and mystery, and you can't help but wonder what secrets it holds.

The mysterious vine door stands at the entrance of the hut.

In the middle of the room, there's a ladder that leads up to a trapdoor in the ceiling. It's unclear where the ladder might lead, but you can't help but wonder what secrets the hut holds.

Cauldron is on top of the fireplace. It is boiling something.

>climb ladder
Library
As you make your way over to the ladder, you notice that the trapdoor is heavy and requires some effort to open. But once you manage to lift it, you're greeted with the sight of a spacious and well-lit library. There are shelves upon shelves of books, ranging from ancient texts to modern novels. A ladder on wheels sits against one of the walls, allowing you to easily reach the higher shelves. A large desk sits in the center of the room, with a comfortable-looking armchair pulled up to it. Sunlight streams in through a skylight overhead, casting a warm glow over the space. It's clear that this is a place of learning and knowledge, and you feel a sense of excitement at the prospect of exploring all the books and secrets it holds.

You can see Solomon here.

At the top of tthe pearch in the corner of the libary, you see a majectic owl. Before you got a chance to do anything it speaks

Solomon: I am Solomon, keeper of knowledge and guardian of this sacred space. If you seek information, I may be able to help you find what you're looking for.

Despite his serious demeanor, there is a twinkle in Solomon's eye that suggests he might have a mischievous side as well. You get the feeling that there is much more to this magical owl than meets the eye.

>look solomon
A majestic owl with piercing yellow eyes and soft, fluffy feathers. His wings are tucked neatly against his body, and he sits atop a perch in the corner of the library, quietly observing everything that goes on around him. But don't be fooled by his calm exterior - Solomon is far from ordinary.

* * *

>pick orchid
As you pluck the orchid from its stem, the sky suddenly grows dark, as if the very act of picking the flower has brought on nightfall. You look up at the sky in surprise, watching as the stars begin to twinkle above you. The moon rises, full and round, casting a pale glow over the landscape.

But even though the night is dark, you are not afraid. You have the orchid, and the flower seems to pulse with a magical energy, providing a soft and gentle light that illuminates your surroundings. The petals of the orchid glow softly, casting a warm and comforting glow that helps you see your way through the darkness. You feel a sense of wonder and amazement as you walk, marveling at the way the orchid seems to light your path with its magic. The moon and the stars provide good visibility, and you feel a sense of peace and contentment as you make your way through the night.

* * *

>w
(first opening the mysterious vine door)
As you approach the massive vine door, the thick tendrils coiling and writhing as if alive, you can't help but feel a sense of mystery and danger emanating from it. The vines are so dense that you can't see what lies beyond them, adding to the sense of uncertainty.

You reach out tentatively to touch the vines, and they seem to pulse and writhe under your fingers. It's as if they are trying to communicate something to you, but you can't decipher their message.

Despite the eerie feeling that surrounds the vine door, you can't shake the feeling that there is something important waiting for you on the other side. You pull out the magical white orchid flower that you obtained earlier and hold it up to the vines.

To your surprise, the vines immediately calm and stop writhing. The dense foliage begins to part, revealing a small opening that you can just fit through.

Before going to the other side of the door however, you are greeted by a stunning sight. The sun is rising over the horizon, casting a warm glow over the entire forest. The trees and plants in the garden and the whole forest seems to come alive, shining and shimmering in the morning light.

You stand there for a moment, marveling at the beauty of it all. It's as if the mysterious vine door was the key to unlocking a hidden world, full of magic and wonder.

You take a deep breath and step through the opening, feeling a sense of anticipation and excitement wash over you as you wonder what lies ahead.

hut
The hut is small and cozy, with thick stone walls that keep out the cold. A fire is crackling in the fireplace, and a large cauldron is boiling away on top of it, sending thick plumes of steam into the air. The smell of herbs and spices fills the room, and you can see a variety of strange and mystical objects scattered throughout the space. There are shelves lined with old leather-bound books, crystals and gemstones, and various alchemy equipment like beakers, flasks, and Bunsen burners. In the corner, there's a workbench covered in papers and diagrams, with a microscope and a set of delicate instruments. The hut feels like a place of magic and mystery, and you can't help but wonder what secrets it holds.

The mysterious vine door stands at the entrance of the hut.

In the middle of the room, there's a ladder that leads up to a trapdoor in the ceiling. It's unclear where the ladder might lead, but you can't help but wonder what secrets the hut holds.

Cauldron is on top of the fireplace. It is boiling something.

>n
You can't go that way.

>up
Library
As you make your way over to the ladder, you notice that the trapdoor is heavy and requires some effort to open. But once you manage to lift it, you're greeted with the sight of a spacious and well-lit library. There are shelves upon shelves of books, ranging from ancient texts to modern novels. A ladder on wheels sits against one of the walls, allowing you to easily reach the higher shelves. A large desk sits in the center of the room, with a comfortable-looking armchair pulled up to it. Sunlight streams in through a skylight overhead, casting a warm glow over the space. It's clear that this is a place of learning and knowledge, and you feel a sense of excitement at the prospect of exploring all the books and secrets it holds.

A majestic owl gazes at you with piercing yellow eyes and soft, fluffy feathers atop a perch in the corner of the library.

At the top of tthe pearch in the corner of the libary, you see a majectic owl. Before you got a chance to do anything it speaks

Solomon: I am Solomon, keeper of knowledge and guardian of this sacred space. If you seek information, I may be able to help you find what you're looking for.

Despite his serious demeanor, there is a twinkle in Solomon's eye that suggests he might have a mischievous side as well. You get the feeling that there is much more to this magical owl than meets the eye.

>talk to Solomon
Medros: I'm seeking a way out. Do you know of any way I can leave this place?

Solomon: Ah, so you are looking for a way out. Well, you have come to the right place. The library holds many secrets that may be of use to you on your journey. Have you considered seeking out the magic of the witch?

Medros: The magic of the witch? What do you mean?

Solomon: It is said that the witch who lives in these parts possesses a powerful magic, magic that could be harnessed for good or for evil. But be warned - such magic may come with a great cost. You must be willing to sacrifice everything in order to achieve what you seek.

Medros: How do I find this magic?

Solomon: That, I cannot say. But perhaps you will find the answers you seek within the pages of these books. Good luck on your journey, brave adventurer.

>read a book
As you wander through the shelves of the library, your eye is drawn to a particular book. It's a small, unassuming volume, bound in faded leather and adorned with strange symbols. The title on the spine reads "My Diary".Something about the book seems to call to you, and before you know it, you're reaching out to take it off the shelf. As you open the cover, you can't help but feel a sense of excitement and curiosity. This confirms your suspicion. This book being witches personal journal.

Inside, you find pages upon pages of handwritten text, detailing the witch's thoughts and experiences. One entry in particular catches your eye. It's a recipe for a special brew, one that is said to produce a frozen frog. The witch writes that the frog, once thawed, grants the consumer a special ability. You can't believe what you're reading - it all sounds like something out of a fairy tale. But as you continue to read, you begin to realize that perhaps there is more truth to this magic than you initially thought. You can't wait to try out the recipe and see what kind of power it holds.

 You recall of the boiling cauldron downstairs, perharps this can be it. But you shiver at the thought of what that implies or what else is waiting for you...

>gain knowledge
As you wander through the shelves of the library, your eye is drawn to a particular book. It's a small, unassuming volume, bound in faded leather and adorned with strange symbols. The title on the spine reads "My Diary".Something about the book seems to call to you, and before you know it, you're reaching out to take it off the shelf. As you open the cover, you can't help but feel a sense of excitement and curiosity. This confirms your suspicion. This book being witches personal journal.

Inside, you find pages upon pages of handwritten text, detailing the witch's thoughts and experiences. One entry in particular catches your eye. It's a recipe for a special brew, one that is said to produce a frozen frog. The witch writes that the frog, once thawed, grants the consumer a special ability. You can't believe what you're reading - it all sounds like something out of a fairy tale. But as you continue to read, you begin to realize that perhaps there is more truth to this magic than you initially thought. You can't wait to try out the recipe and see what kind of power it holds.

 You recall of the boiling cauldron downstairs, perharps this can be it. But you shiver at the thought of what that implies or what else is waiting for you...

>down
hut
The hut is small and cozy, with thick stone walls that keep out the cold. A fire is crackling in the fireplace, and a large cauldron is boiling away on top of it, sending thick plumes of steam into the air. The smell of herbs and spices fills the room, and you can see a variety of strange and mystical objects scattered throughout the space. There are shelves lined with old leather-bound books, crystals and gemstones, and various alchemy equipment like beakers, flasks, and Bunsen burners. In the corner, there's a workbench covered in papers and diagrams, with a microscope and a set of delicate instruments. The hut feels like a place of magic and mystery, and you can't help but wonder what secrets it holds.

The mysterious vine door stands at the entrance of the hut.

In the middle of the room, there's a ladder that leads up to a trapdoor in the ceiling. It's unclear where the ladder might lead, but you can't help but wonder what secrets the hut holds.

Cauldron is on top of the fireplace. It is boiling something.

>look cauldron
A large iron cauldron sits in the center of the room, filled with bubbling greenish water. It gives off a strange, pungent smell, and steam rises from the surface. There are various herbs and roots scattered around the cauldron, and a mysterious, greenish liquid boils inside.

>examine cauldron
A large iron cauldron sits in the center of the room, filled with bubbling greenish water. It gives off a strange, pungent smell, and steam rises from the surface. There are various herbs and roots scattered around the cauldron, and a mysterious, greenish liquid boils inside.

>carry cauldron
You assume you can find the mysterious frozen frog inside, but this is not the way, you have to somehow reach inside without using your good hands, the cauldron is boiling. Maybe if you try and spill it...

>e
(first opening the mysterious vine door)

>ask nero about mistress
Medros: Can you tell me about your master, the witch?

Nero: My mistress is a powerful and wise woman, gifted with the ability to wield magic. She is kind and compassionate, always seeking to use her powers for the greater good. I am honored to serve as her loyal companion and protector, and I would do anything to keep her safe.

Medros: How did you come to be her companion?

Nero: I was just a kitten when my mistress found me, abandoned and alone on the streets. She took me in and cared for me, and over time we became the best of friends. I have been by her side ever since, learning from her and aiding her in any way I can.

Medros: What kind of magic does your mistress wield?

Nero: My mistress is skilled in many different kinds of magic. She is an expert in herbology and alchemy, able to create powerful potions and elixirs. She is also gifted with the ability to cast spells and control the elements. But most of all, she is a powerful healer, able to use her magic to ease suffering and bring about positive change.

Medros: Why is she testing me?

Nero: To prove your worth? To prove that you don't take your life for granted. Maybe to so you can reflect about your life. I am not sure of the exact reason, as you are not the first one in this position. But if your intentions are pure, and you are willing to right your wrongs, you don't have to be afraid of her. If that's not the case... Good luck! Fufufufu

>ask nero about the witch
Nero: I'm sorry Medros, this is not something I can help you with!

>w
hut
The hut is small and cozy, with thick stone walls that keep out the cold. A fire is crackling in the fireplace, and a large cauldron is boiling away on top of it, sending thick plumes of steam into the air. The smell of herbs and spices fills the room, and you can see a variety of strange and mystical objects scattered throughout the space. There are shelves lined with old leather-bound books, crystals and gemstones, and various alchemy equipment like beakers, flasks, and Bunsen burners. In the corner, there's a workbench covered in papers and diagrams, with a microscope and a set of delicate instruments. The hut feels like a place of magic and mystery, and you can't help but wonder what secrets it holds.

The mysterious vine door stands at the entrance of the hut.

In the middle of the room, there's a ladder that leads up to a trapdoor in the ceiling. It's unclear where the ladder might lead, but you can't help but wonder what secrets the hut holds.

Cauldron is on top of the fireplace. It is boiling something.

>w
You can't go that way.

* * *

>w
You can't go that way.

>go w
You can't go that way.

* * *

>e
forest
You are in a dense forest, surrounded by tall trees and thick underbrush. It's hard to see more than a few feet in any direction. The trees are tall and their leaves rustle softly in the breeze. You can hear the distant sound of a stream nearby. The air is fresh and cool, and the ground is soft beneath you. It looks like you are alone in the forest.

* * *

>w
hut
The hut is small and cozy, with thick stone walls that keep out the cold. A fire is crackling in the fireplace, and a large cauldron is boiling away on top of it, sending thick plumes of steam into the air. The smell of herbs and spices fills the room, and you can see a variety of strange and mystical objects scattered throughout the space. There are shelves lined with old leather-bound books, crystals and gemstones, and various alchemy equipment like beakers, flasks, and Bunsen burners. In the corner, there's a workbench covered in papers and diagrams, with a microscope and a set of delicate instruments. The hut feels like a place of magic and mystery, and you can't help but wonder what secrets it holds.

The mysterious vine door stands at the entrance of the hut.

In the middle of the room, there's a ladder that leads up to a trapdoor in the ceiling. It's unclear where the ladder might lead, but you can't help but wonder what secrets the hut holds.

Cauldron is on top of the fireplace. It is boiling something.

* * *

>up
Library
As you make your way over to the ladder, you notice that the trapdoor is heavy and requires some effort to open. But once you manage to lift it, you're greeted with the sight of a spacious and well-lit library. There are shelves upon shelves of books, ranging from ancient texts to modern novels. A ladder on wheels sits against one of the walls, allowing you to easily reach the higher shelves. A large desk sits in the center of the room, with a comfortable-looking armchair pulled up to it. Sunlight streams in through a skylight overhead, casting a warm glow over the space. It's clear that this is a place of learning and knowledge, and you feel a sense of excitement at the prospect of exploring all the books and secrets it holds.

A majestic owl gazes at you with piercing yellow eyes and soft, fluffy feathers atop a perch in the corner of the library.

>ask solomon about witch
Medros: Can you tell me about your master, the witch?

Solomon: My mistress is a highly intelligent and knowledgeable woman, with a deep understanding of many different subjects. She has a particular interest in the magical arts, and she is always seeking out new information and insights. I am honored to serve as her loyal companion and library keeper, and I am constantly learning from her.

Medros: How did you come to be her companion?

Solomon: I have been with my mistress for many years. She found me as a young owl, injured and alone, and took me in. She nursed me back to health and we have been inseparable ever since. She recognized my love of knowledge and appointed me as the keeper of her library. I have learned so much from her and the books in our collection, and I am grateful to be able to share that knowledge with others.

Medros: What is your mistress like?

Solomon: My mistress is a kind and compassionate woman, with a strong sense of justice. She is always seeking out ways to help others and make the world a better place. However, she can also be quite ruthless if she feels threatened or if her loved ones are in danger. It is best not to get on her bad side. Despite this, I am proud to serve such a remarkable woman.

>down
hut
The hut is small and cozy, with thick stone walls that keep out the cold. A fire is crackling in the fireplace, and a large cauldron is boiling away on top of it, sending thick plumes of steam into the air. The smell of herbs and spices fills the room, and you can see a variety of strange and mystical objects scattered throughout the space. There are shelves lined with old leather-bound books, crystals and gemstones, and various alchemy equipment like beakers, flasks, and Bunsen burners. In the corner, there's a workbench covered in papers and diagrams, with a microscope and a set of delicate instruments. The hut feels like a place of magic and mystery, and you can't help but wonder what secrets it holds.

The mysterious vine door stands at the entrance of the hut.

In the middle of the room, there's a ladder that leads up to a trapdoor in the ceiling. It's unclear where the ladder might lead, but you can't help but wonder what secrets the hut holds.

Cauldron is on top of the fireplace. It is boiling something.

* * *

>spill cauldron
You spill the hot cauldron on the floor. The whole floor is wet. You can see the frozen frog dropping from the cauldron. You try to pick it up and find that it is as cold as ice. You keep it.

* * *

>w
hut
The hut is small and cozy, with thick stone walls that keep out the cold. A fire is crackling in the fireplace, and a large cauldron is boiling away on top of it, sending thick plumes of steam into the air. The smell of herbs and spices fills the room, and you can see a variety of strange and mystical objects scattered throughout the space. There are shelves lined with old leather-bound books, crystals and gemstones, and various alchemy equipment like beakers, flasks, and Bunsen burners. In the corner, there's a workbench covered in papers and diagrams, with a microscope and a set of delicate instruments. The hut feels like a place of magic and mystery, and you can't help but wonder what secrets it holds.

The mysterious vine door stands at the entrance of the hut.

In the middle of the room, there's a ladder that leads up to a trapdoor in the ceiling. It's unclear where the ladder might lead, but you can't help but wonder what secrets the hut holds.

>i
You are carrying:
  Frozen frog
  a magical white orchid
  Alpine rope

>eat frig
You can't see any such thing.

>eat frog
It is a silly dare really, one that you had taken on a whim, and now you were regretting it. The icy flesh of the frog was hard between your fingers, and you hesitated, feeling a sense of dread wash over you. But you had come this far, and there was no backing down now. You took a deep breath and swallowed the whole frog, hoping that it wouldn't taste as bad as it looked.

As you bit into the icy flesh of the frog, something strange began to happen. You feel a sudden shift in your perception, as if a veil has been lifted from your eyes. Suddenly, you can see things that were previously hidden in the shadows. The world takes on a new dimension, and you feel a sense of heightened awareness and perception. You feel like you have superpowers, able to navigate the darkness with ease and pick out details that others might miss. At the same time, the shift in perception is disorienting, as your eyes adjust to seeing in a different way. You feel a sense of discomfort or dizziness as your brain adjusts to this new way of seeing.

>e
garden
The garden is a small, overgrown patch of land located in front of the  hut. The garden is surrounded by a high, wooden fence, topped with barbed wire and warning signs. The fence serves to keep out intruders and to protect the rare and exotic plants that grow within.

The ground is thick with weeds and moss, and the air is heavy with the aroma of herbs and spices. The plants in the garden are a mishmash of medicinal and poisonous varieties, carefully tended to by someone. There are rows of medicinal herbs such as lavender, basil, and chamomile, as well as deadly nightshade, mandrake root, and henbane.

In the center of the garden is a large, ancient oak tree, its branches gnarled and twisted. The tree is said to be enchanted, and is the source of much of the witch's power. It is said that if you are brave enough to pluck a leaf from the tree, you will be granted a wish. But be warned, you get the feeling something is fiercely protective of  garden and will not hesitate to dispose anyone who tries to harm it.

Overall, the  garden is a mysterious and dangerous place, filled with secrets and magic. It is a place to be respected and feared, but also one of great power and potential.

The mysterious vine door stands at the entrance of the hut.

Nero gazes upon you with his piercing green eyes, smirking.

!!!As you enter the Garden, Nero excitedly greets you.!!!

Nero: You really did it! Fufufu

Nero: How does it feel?

Medros: How does what feel?

Nero: Go check out the cave and you will se what I am talking about! Fufufufu

>e
forest
You are in a dense forest, surrounded by tall trees and thick underbrush. It's hard to see more than a few feet in any direction. The trees are tall and their leaves rustle softly in the breeze. You can hear the distant sound of a stream nearby. The air is fresh and cool, and the ground is soft beneath you. It looks like you are alone in the forest.

>s
ravine
You make your way down into a deep ravine, where you find a babbling brook running through the bottom. The water looks clear and cool, and you're tempted to take a drink. You notice a small cave on the other side of the ravine, which might be worth exploring.

The babbling brook runs through the bottom of the ravine, its clear, cool water inviting you to take a drink. You see small fish swimming through the water and hear the soothing sound of the flowing stream.

There is also an abandoned camp that you found earlier

>s
You can't go that way.

>down
You darkvision allows you to see silhouettes of the layout in front of you!

cave
You approach the dark cave cautiously, trying not to make too much noise. The air is damp and musty, and you can hear the sound of dripping water echoing through the cavern. You are glad that you have darkvision, as it allows you to see clearly in the dimly lit cave.

As you make your way deeper into the cave, you are struck by the beauty of the stalactites and stalagmites that line the walls. Some of them are sharp and jagged, while others are smooth and rounded. Water drips from the ceiling, forming small puddles on the floor. You can see the reflections of the stalactites and stalagmites in the water, creating an otherworldly effect.

You hear the sound of something moving in the shadows, and you tense up. You're not sure if it's safe to go any further, but you can't just turn back now. You take a deep breath and steel yourself for whatever lies ahead. As you continue to explore the cave, you can't help but feel a sense of wonder and excitement at the unknown dangers and mysteries that await you.

As you venture deeper into the cave, you are startled by a sudden glint of light. You pause, trying to figure out where it's coming from. As you move closer, you see that it's coming from a small body of water up ahead. The water is crystal clear it seemes to reflect some light, giving it a glistening appearance. You can see the shadows of fish swimming beneath the surface, and you can hear the sound of water dripping from the stalactites overhead. You approach the pond with caution, marveling at the beauty of this hidden gem. You wonder what other secrets and treasures the cave might hold.

>look
cave
You approach the dark cave cautiously, trying not to make too much noise. The air is damp and musty, and you can hear the sound of dripping water echoing through the cavern. You are glad that you have darkvision, as it allows you to see clearly in the dimly lit cave.

As you make your way deeper into the cave, you are struck by the beauty of the stalactites and stalagmites that line the walls. Some of them are sharp and jagged, while others are smooth and rounded. Water drips from the ceiling, forming small puddles on the floor. You can see the reflections of the stalactites and stalagmites in the water, creating an otherworldly effect.

You hear the sound of something moving in the shadows, and you tense up. You're not sure if it's safe to go any further, but you can't just turn back now. You take a deep breath and steel yourself for whatever lies ahead. As you continue to explore the cave, you can't help but feel a sense of wonder and excitement at the unknown dangers and mysteries that await you.

As you venture deeper into the cave, you are startled by a sudden glint of light. You pause, trying to figure out where it's coming from. As you move closer, you see that it's coming from a small body of water up ahead. The water is crystal clear it seemes to reflect some light, giving it a glistening appearance. You can see the shadows of fish swimming beneath the surface, and you can hear the sound of water dripping from the stalactites overhead. You approach the pond with caution, marveling at the beauty of this hidden gem. You wonder what other secrets and treasures the cave might hold.

>look
cave
You approach the dark cave cautiously, trying not to make too much noise. The air is damp and musty, and you can hear the sound of dripping water echoing through the cavern. You are glad that you have darkvision, as it allows you to see clearly in the dimly lit cave.

As you make your way deeper into the cave, you are struck by the beauty of the stalactites and stalagmites that line the walls. Some of them are sharp and jagged, while others are smooth and rounded. Water drips from the ceiling, forming small puddles on the floor. You can see the reflections of the stalactites and stalagmites in the water, creating an otherworldly effect.

You hear the sound of something moving in the shadows, and you tense up. You're not sure if it's safe to go any further, but you can't just turn back now. You take a deep breath and steel yourself for whatever lies ahead. As you continue to explore the cave, you can't help but feel a sense of wonder and excitement at the unknown dangers and mysteries that await you.

As you venture deeper into the cave, you are startled by a sudden glint of light. You pause, trying to figure out where it's coming from. As you move closer, you see that it's coming from a small body of water up ahead. The water is crystal clear it seemes to reflect some light, giving it a glistening appearance. You can see the shadows of fish swimming beneath the surface, and you can hear the sound of water dripping from the stalactites overhead. You approach the pond with caution, marveling at the beauty of this hidden gem. You wonder what other secrets and treasures the cave might hold.

* * *

>Meditate
*** You close your eyes, feeling the power of the pond flowing through your veins.You focus on your breath and let go of all of your worries and doubts. You allow yourself to sink into a deep state of meditation, letting your mind wander freely.

You find yourself transported to a place of endless possibility, where anything is possible. You feel a sense of unity with the universe, and you understand that you are a part of something much greater than yourself. You see visions of the past and the future, and you understand that you are a link in the chain of existence.

You feel a sense of purpose and direction, and you know that you are exactly where you are meant to be. You are filled with a sense of calm and contentment, and you know that you are ready to embrace your power and your destiny. You remain in this state of meditation for what feels like an eternity, before slowly emerging back into the present moment.

You open your eyes, feeling refreshed and renewed. You realise you are where you last remembered you went to sleep. Was it all just a dream? You stand up, feeling a sense of determination and purpose. You look down and you see an amulet glistening, you don't know how this amulet was brought to you, but you have an idea... Glinda. With that in mind you are not really sure what happened but you are ready to face whatever challenges may come your way, knowing that you are stronger and wiser than ever before. ***

Would you like to RESTART, RESTORE a saved game, QUIT or UNDO the last command?

* * *

>pick cherry
(the Cherry Blossom Tree)
That's hardly portable.

>pick cherry fruit
Taken.

>eat cherry fruit
As you bite into the cherry, you feel a burst of sweetness flood your mouth. The juice is like ambrosia, nourishing and revitalizing you with each swallow. You feel a sense of strength and energy coursing through your veins, as if you could climb the mountain a hundred times and not feel the slightest bit of fatigue.

You finish the cherry and toss the pit aside, feeling a sense of renewal wash over you. You are ready to tackle the mountain again, to climb to the peak and conquer the challenges that lie ahead. The cherry has given you the strength and determination to succeed, and you know that you can do anything you set your mind to.

You toss the cherry pit aside, watching as it tumbles through the air and lands on the ground. But as you look on in amazement, something strange begins to happen. The wind picks up, blowing a shower of cherry blossom petals from the tree above. The petals twist and twirl around the cherry pit, forming a swirling mass of white and black. And then, in a matter of seconds, a beautiful orchid blooms from the cherry pit, its white petals stark against the dark, velvety center.

You stare in awe at the orchid, marveling at the way it appeared out of nowhere. The flower seems to pulsate with a magical energy, as if it were alive and breathing. You can't help but feel a sense of wonder and amazement at the sight, knowing that you have witnessed something truly special and extraordinary. The orchid is a symbol of beauty and magic, a reminder of the wonders that can be found in the world around us.

>s
forest
You are in a dense forest, surrounded by tall trees and thick underbrush. It's hard to see more than a few feet in any direction. The trees are tall and their leaves rustle softly in the breeze. You can hear the distant sound of a stream nearby. The air is fresh and cool, and the ground is soft beneath you. It looks like you are alone in the forest.

* * *

>w
(first opening the mysterious vine door)

* * *

>w
(first opening the mysterious vine door)
It seems to be locked.

>e
forest
You are in a dense forest, surrounded by tall trees and thick underbrush. It's hard to see more than a few feet in any direction. The trees are tall and their leaves rustle softly in the breeze. You can hear the distant sound of a stream nearby. The air is fresh and cool, and the ground is soft beneath you. It looks like you are alone in the forest.

>n
The cliff rises up before you, its rocky face sheer and imposing. It looks impossible to scale without proper equipment. Luckily you got the alpine rope from the ravine. You throw it up, like magic the rope extends to the farthest cliff and attaches itself. This rope is no ordinary rope, as you stand in awe as the rope is tightly secured, this must be witches work you think to yourself before gripping the rope and starting the mounmental climb

You can feel the sweat dripping down your face as you pull yourself up the mountain, the rough rock face scraping against your fingertips. Your muscles are burning with the effort of hauling yourself up, inch by inch. You glance down at the rope that anchors you to the mountain, a thin lifeline in this vast expanse of stone and ice.

The wind howls around you, whipping your hair into your face and biting through your layers of clothing. You clench your jaw and keep climbing, determined to reach the peak that beckons above you.

Every step is a struggle, your legs shaking with the effort of supporting your weight on the narrow ledges and handholds. But you don't give up, even when your hands are numb with cold and your breath comes in ragged gasps.

At last, you reach the top and collapse onto the snowy summit, your chest heaving with the exertion of the climb. It's a feeling of exhilaration and exhaustion all at once, the sense of accomplishment washing over you as you bask in the glory of the view.

But as you look out at the dizzying expanse below, you know that the struggle to reach this peak was worth it, and you can't wait to tackle the next challenge that comes your way.

mountain peak
This is the top of a mountain peak, where you have a breathtaking view of the surrounding landscape.  The golden sunset paints the sky in a dazzling array of orange, pink, and yellow hues, casting a warm glow over the landscape. As the sun dips below the horizon, the colors intensify, creating a breathtaking spectacle that fills the sky with a riot of color. You can see for miles in every direction, but unfortunately you don't recognize any of it. What you do see however is the cherry blossom tree that stands tall in the middle of the mountain peak with all it's beauty, remainding you of the whole experience with the climb and orchid

You can see a magical white orchid here.

>pick orchid
As you pluck the orchid from its stem, the sky suddenly grows dark, as if the very act of picking the flower has brought on nightfall. You look up at the sky in surprise, watching as the stars begin to twinkle above you. The moon rises, full and round, casting a pale glow over the landscape.

But even though the night is dark, you are not afraid. You have the orchid, and the flower seems to pulse with a magical energy, providing a soft and gentle light that illuminates your surroundings. The petals of the orchid glow softly, casting a warm and comforting glow that helps you see your way through the darkness. You feel a sense of wonder and amazement as you walk, marveling at the way the orchid seems to light your path with its magic. The moon and the stars provide good visibility, and you feel a sense of peace and contentment as you make your way through the night.

* * *

>w
(first opening the mysterious vine door)
It seems to be locked.

>i
You are carrying:
  a magical white orchid
  Alpine rope

>w
(first opening the mysterious vine door)
It seems to be locked.

>unlock
What do you want to unlock?

* * *

>vine door
What do you want to unlock the mysterious vine door with?

>orchid
You unlock the mysterious vine door.

>w
(first opening the mysterious vine door)

>w
You can't go that way.

I beg your pardon?

* * *

>n
forest
You are in a dense forest, surrounded by tall trees and thick underbrush. It's hard to see more than a few feet in any direction. The trees are tall and their leaves rustle softly in the breeze. You can hear the distant sound of a stream nearby. The air is fresh and cool, and the ground is soft beneath you. It looks like you are alone in the forest.

>w
garden
The garden is a small, overgrown patch of land located in front of the  hut. The garden is surrounded by a high, wooden fence, topped with barbed wire and warning signs. The fence serves to keep out intruders and to protect the rare and exotic plants that grow within.

The ground is thick with weeds and moss, and the air is heavy with the aroma of herbs and spices. The plants in the garden are a mishmash of medicinal and poisonous varieties, carefully tended to by someone. There are rows of medicinal herbs such as lavender, basil, and chamomile, as well as deadly nightshade, mandrake root, and henbane.

In the center of the garden is a large, ancient oak tree, its branches gnarled and twisted. The tree is said to be enchanted, and is the source of much of the witch's power. It is said that if you are brave enough to pluck a leaf from the tree, you will be granted a wish. But be warned, you get the feeling something is fiercely protective of  garden and will not hesitate to dispose anyone who tries to harm it.

Overall, the  garden is a mysterious and dangerous place, filled with secrets and magic. It is a place to be respected and feared, but also one of great power and potential.

The mysterious vine door stands at the entrance of the hut.

Nero gazes upon you with his piercing green eyes, smirking.

>talk to nero
Medros: Who are you? How did you get in here?

 Nero: I am Nero, a magical feline with the ability to teleport. I have been watching you for some time. The witch wants to keep an eye out on you.

(Nero laughs smirkly)Medros: I'm just trying to get to the hut to find some supplies, I didn't know this was witches, but there's a vine door blocking my way. Do you know how I can get through it?

Nero: Ah,  your first test is the vine door. It can only be unlocked with a special flower. But this flower does not grow in the garden. It can only be found on the mountain peak, high above the clouds.

Nero: Oh and another thing, I will be your guide for this trial, if you ever fill stuck just ask me "What now?"

>what now
That's not a verb I recognise.

>ask nero about what
Nero: I'm sorry Medros, this is not something I can help you with!

>ask nero about what now
Nero: You should try to pick the flower on top of the mountain peak so you can unlock the doors

>e
forest
You are in a dense forest, surrounded by tall trees and thick underbrush. It's hard to see more than a few feet in any direction. The trees are tall and their leaves rustle softly in the breeze. You can hear the distant sound of a stream nearby. The air is fresh and cool, and the ground is soft beneath you. It looks like you are alone in the forest.

>s
ravine
You make your way down into a deep ravine, where you find a babbling brook running through the bottom. The water looks clear and cool, and you're tempted to take a drink. You notice a small cave on the other side of the ravine, which might be worth exploring.

The babbling brook runs through the bottom of the ravine, its clear, cool water inviting you to take a drink. You see small fish swimming through the water and hear the soothing sound of the flowing stream. You can also see a dark cave down from ravine, but it gives you an ominous feeling

You can see a Female Otter here.

The female otter swims up to you and looks at you with curious eyes. She seems to be trying to communicate something to you, and you get the feeling that she wants you to follow her.

* * *

>n
forest
You are in a dense forest, surrounded by tall trees and thick underbrush. It's hard to see more than a few feet in any direction. The trees are tall and their leaves rustle softly in the breeze. You can hear the distant sound of a stream nearby. The air is fresh and cool, and the ground is soft beneath you. It looks like you are alone in the forest.

>n
The cliff rises up before you, its rocky face sheer and imposing. It looks impossible to scale without proper equipment. Luckily you got the alpine rope from the ravine. You throw it up, like magic the rope extends to the farthest cliff and attaches itself. This rope is no ordinary rope, as you stand in awe as the rope is tightly secured, this must be witches work you think to yourself before gripping the rope and starting the mounmental climb

You can feel the sweat dripping down your face as you pull yourself up the mountain, the rough rock face scraping against your fingertips. Your muscles are burning with the effort of hauling yourself up, inch by inch. You glance down at the rope that anchors you to the mountain, a thin lifeline in this vast expanse of stone and ice.

The wind howls around you, whipping your hair into your face and biting through your layers of clothing. You clench your jaw and keep climbing, determined to reach the peak that beckons above you.

Every step is a struggle, your legs shaking with the effort of supporting your weight on the narrow ledges and handholds. But you don't give up, even when your hands are numb with cold and your breath comes in ragged gasps.

At last, you reach the top and collapse onto the snowy summit, your chest heaving with the exertion of the climb. It's a feeling of exhilaration and exhaustion all at once, the sense of accomplishment washing over you as you bask in the glory of the view.

But as you look out at the dizzying expanse below, you know that the struggle to reach this peak was worth it, and you can't wait to tackle the next challenge that comes your way.

mountain peak
This is the top of a mountain peak, where you have a breathtaking view of the surrounding landscape.  The golden sunset paints the sky in a dazzling array of orange, pink, and yellow hues, casting a warm glow over the landscape. As the sun dips below the horizon, the colors intensify, creating a breathtaking spectacle that fills the sky with a riot of color. You can see for miles in every direction, but unfortunately you don't recognize any of it. What worries you is that you don't see the flower which Nero mention.

What you do see however is the cherry blossom tree that stands tall in the middle of the mountain peak with all it's beauty, you might want to check it out.

>pick cherries
Taken.

* * *

>talk to nero
You did well by finding magical white orchid, now you can proceed to the hut, the next challenge awaits for you inside... fufufu

>ask nero about what now
You did well by finding magical white orchid, now you can proceed to the hut, the next challenge awaits for you inside... fufufu

>w
(first opening the mysterious vine door)
As you approach the massive vine door, the thick tendrils coiling and writhing as if alive, you can't help but feel a sense of mystery and danger emanating from it. The vines are so dense that you can't see what lies beyond them, adding to the sense of uncertainty.

You reach out tentatively to touch the vines, and they seem to pulse and writhe under your fingers. It's as if they are trying to communicate something to you, but you can't decipher their message.

Despite the eerie feeling that surrounds the vine door, you can't shake the feeling that there is something important waiting for you on the other side. You pull out the magical white orchid flower that you obtained earlier and hold it up to the vines.

To your surprise, the vines immediately calm and stop writhing. The dense foliage begins to part, revealing a small opening that you can just fit through.

Before going to the other side of the door however, you are greeted by a stunning sight. The sun is rising over the horizon, casting a warm glow over the entire forest. The trees and plants in the garden and the whole forest seems to come alive, shining and shimmering in the morning light.

You stand there for a moment, marveling at the beauty of it all. It's as if the mysterious vine door was the key to unlocking a hidden world, full of magic and wonder.

You take a deep breath and step through the opening, feeling a sense of anticipation and excitement wash over you as you wonder what lies ahead.

hut
The hut is small and cozy, with thick stone walls that keep out the cold. A fire is crackling in the fireplace, and a large cauldron is boiling away on top of it, sending thick plumes of steam into the air. The smell of herbs and spices fills the room, and you can see a variety of strange and mystical objects scattered throughout the space. There are shelves lined with old leather-bound books, crystals and gemstones, and various alchemy equipment like beakers, flasks, and Bunsen burners. In the corner, there's a workbench covered in papers and diagrams, with a microscope and a set of delicate instruments. The hut feels like a place of magic and mystery, and you can't help but wonder what secrets it holds.

The mysterious vine door stands at the entrance of the hut.

In the middle of the room, there's a ladder that leads up to a trapdoor in the ceiling. It's unclear where the ladder might lead, but you can't help but wonder what secrets the hut holds.

Cauldron is on top of the fireplace. It is boiling something.

>climb ladder
Library
As you make your way over to the ladder, you notice that the trapdoor is heavy and requires some effort to open. But once you manage to lift it, you're greeted with the sight of a spacious and well-lit library. There are shelves upon shelves of books, ranging from ancient texts to modern novels. A ladder on wheels sits against one of the walls, allowing you to easily reach the higher shelves. A large desk sits in the center of the room, with a comfortable-looking armchair pulled up to it. Sunlight streams in through a skylight overhead, casting a warm glow over the space. It's clear that this is a place of learning and knowledge, and you feel a sense of excitement at the prospect of exploring all the books and secrets it holds.

A majestic owl gazes at you with piercing yellow eyes and soft, fluffy feathers atop a perch in the corner of the library.

At the top of the pearch in the corner of the libary, you see a majectic owl. Before you got a chance to do anything it speaks

Solomon: I am Solomon, keeper of knowledge and guardian of this sacred space. If you seek information, I may be able to help you find what you're looking for.

Despite his serious demeanor, there is a twinkle in Solomon's eye that suggests he might have a mischievous side as well. You get the feeling that there is much more to this magical owl than meets the eye.

>read
As you wander through the shelves of the library, your eye is drawn to a particular book. It's a small, unassuming volume, bound in faded leather and adorned with strange symbols. The title on the spine reads "My Diary".Something about the book seems to call to you, and before you know it, you're reaching out to take it off the shelf. As you open the cover, you can't help but feel a sense of excitement and curiosity. This confirms your suspicion. This book being witches personal journal.

Inside, you find pages upon pages of handwritten text, detailing the witch's thoughts and experiences. One entry in particular catches your eye. It's a recipe for a special brew, one that is said to produce a frozen frog. The witch writes that the frog, once thawed, grants the consumer a special ability. You can't believe what you're reading - it all sounds like something out of a fairy tale. But as you continue to read, you begin to realize that perhaps there is more truth to this magic than you initially thought. You can't wait to try out the recipe and see what kind of power it holds.

 You recall of the boiling cauldron downstairs, perharps this can be it. But you shiver at the thought of what that implies or what else is waiting for you...

>s
You can't go that way.

>down
hut
The hut is small and cozy, with thick stone walls that keep out the cold. A fire is crackling in the fireplace, and a large cauldron is boiling away on top of it, sending thick plumes of steam into the air. The smell of herbs and spices fills the room, and you can see a variety of strange and mystical objects scattered throughout the space. There are shelves lined with old leather-bound books, crystals and gemstones, and various alchemy equipment like beakers, flasks, and Bunsen burners. In the corner, there's a workbench covered in papers and diagrams, with a microscope and a set of delicate instruments. The hut feels like a place of magic and mystery, and you can't help but wonder what secrets it holds.

The mysterious vine door stands at the entrance of the hut.

In the middle of the room, there's a ladder that leads up to a trapdoor in the ceiling. It's unclear where the ladder might lead, but you can't help but wonder what secrets the hut holds.

Cauldron is on top of the fireplace. It is boiling something.

>up
Library
As you make your way over to the ladder, you notice that the trapdoor is heavy and requires some effort to open. But once you manage to lift it, you're greeted with the sight of a spacious and well-lit library. There are shelves upon shelves of books, ranging from ancient texts to modern novels. A ladder on wheels sits against one of the walls, allowing you to easily reach the higher shelves. A large desk sits in the center of the room, with a comfortable-looking armchair pulled up to it. Sunlight streams in through a skylight overhead, casting a warm glow over the space. It's clear that this is a place of learning and knowledge, and you feel a sense of excitement at the prospect of exploring all the books and secrets it holds.

A majestic owl gazes at you with piercing yellow eyes and soft, fluffy feathers atop a perch in the corner of the library.

At the top of tthe pearch in the corner of the libary, you see a majectic owl. Before you got a chance to do anything it speaks

Solomon: I am Solomon, keeper of knowledge and guardian of this sacred space. If you seek information, I may be able to help you find what you're looking for.

Despite his serious demeanor, there is a twinkle in Solomon's eye that suggests he might have a mischievous side as well. You get the feeling that there is much more to this magical owl than meets the eye.

>talk to owl
You can't see any such thing.

>talk to solomon
Medros: I'm seeking a way out. Do you know of any way I can leave this place?

Solomon: Ah, so you are looking for a way out. Well, you have come to the right place. The library holds many secrets that may be of use to you on your journey. Have you considered seeking out the magic of the witch?

Medros: The magic of the witch? What do you mean?

Solomon: It is said that the witch who lives in these parts possesses a powerful magic, magic that could be harnessed for good or for evil. But be warned - such magic may come with a great cost. You must be willing to sacrifice everything in order to achieve what you seek.

Medros: How do I find this magic?

Solomon: That, I cannot say. But perhaps you will find the answers you seek within the pages of these books. Good luck on your journey, brave adventurer.

>down
hut
The hut is small and cozy, with thick stone walls that keep out the cold. A fire is crackling in the fireplace, and a large cauldron is boiling away on top of it, sending thick plumes of steam into the air. The smell of herbs and spices fills the room, and you can see a variety of strange and mystical objects scattered throughout the space. There are shelves lined with old leather-bound books, crystals and gemstones, and various alchemy equipment like beakers, flasks, and Bunsen burners. In the corner, there's a workbench covered in papers and diagrams, with a microscope and a set of delicate instruments. The hut feels like a place of magic and mystery, and you can't help but wonder what secrets it holds.

The mysterious vine door stands at the entrance of the hut.

In the middle of the room, there's a ladder that leads up to a trapdoor in the ceiling. It's unclear where the ladder might lead, but you can't help but wonder what secrets the hut holds.

Cauldron is on top of the fireplace. It is boiling something.

>spill cauldron
You spill the hot cauldron on the floor. The whole floor is wet. You can see the frozen frog dropping from the cauldron. You try to pick it up and find that it is as cold as ice. You keep it.

>eat frog
It is a silly dare really, one that you had taken on a whim, and now you were regretting it. The icy flesh of the frog was hard between your fingers, and you hesitated, feeling a sense of dread wash over you. But you had come this far, and there was no backing down now. You took a deep breath and swallowed the whole frog, hoping that it wouldn't taste as bad as it looked.

As you bit into the icy flesh of the frog, something strange began to happen. You feel a sudden shift in your perception, as if a veil has been lifted from your eyes. Suddenly, you can see things that were previously hidden in the shadows. The world takes on a new dimension, and you feel a sense of heightened awareness and perception. You feel like you have superpowers, able to navigate the darkness with ease and pick out details that others might miss. At the same time, the shift in perception is disorienting, as your eyes adjust to seeing in a different way. You feel a sense of discomfort or dizziness as your brain adjusts to this new way of seeing.

>e
(first opening the mysterious vine door)
garden
The garden is a small, overgrown patch of land located in front of the  hut. The garden is surrounded by a high, wooden fence, topped with barbed wire and warning signs. The fence serves to keep out intruders and to protect the rare and exotic plants that grow within.

The ground is thick with weeds and moss, and the air is heavy with the aroma of herbs and spices. The plants in the garden are a mishmash of medicinal and poisonous varieties, carefully tended to by someone. There are rows of medicinal herbs such as lavender, basil, and chamomile, as well as deadly nightshade, mandrake root, and henbane.

In the center of the garden is a large, ancient oak tree, its branches gnarled and twisted. The tree is said to be enchanted, and is the source of much of the witch's power. It is said that if you are brave enough to pluck a leaf from the tree, you will be granted a wish. But be warned, you get the feeling something is fiercely protective of  garden and will not hesitate to dispose anyone who tries to harm it.

Overall, the  garden is a mysterious and dangerous place, filled with secrets and magic. It is a place to be respected and feared, but also one of great power and potential.

The mysterious vine door stands at the entrance of the hut.

Nero gazes upon you with his piercing green eyes, smirking.

!!!As you enter the Garden, Nero excitedly greets you.!!!

Nero: You really did it! Fufufu

Nero: How does it feel?

Medros: How does what feel?

Nero: Go check out the cave and you will se what I am talking about! Fufufufu

>e
forest
You are in a dense forest, surrounded by tall trees and thick underbrush. It's hard to see more than a few feet in any direction. The trees are tall and their leaves rustle softly in the breeze. You can hear the distant sound of a stream nearby. The air is fresh and cool, and the ground is soft beneath you. It looks like you are alone in the forest.

>s
ravine
You make your way down into a deep ravine, where you find a babbling brook running through the bottom. The water looks clear and cool, and you're tempted to take a drink. You notice a small cave on the other side of the ravine, which might be worth exploring.

The babbling brook runs through the bottom of the ravine, its clear, cool water inviting you to take a drink. You see small fish swimming through the water and hear the soothing sound of the flowing stream. You can also see a dark cave down from ravine, but it gives you an ominous feeling.

There is also an abandoned camp that you found earlier

>doown
That's not a verb I recognise.

>down
You darkvision allows you to see silhouettes of the layout in front of you!

cave
You approach the dark cave cautiously, trying not to make too much noise. The air is damp and musty, and you can hear the sound of dripping water echoing through the cavern. You are glad that you have darkvision, as it allows you to see clearly in the dimly lit cave.

As you make your way deeper into the cave, you are struck by the beauty of the stalactites and stalagmites that line the walls. Some of them are sharp and jagged, while others are smooth and rounded. Water drips from the ceiling, forming small puddles on the floor. You can see the reflections of the stalactites and stalagmites in the water, creating an otherworldly effect.

You hear the sound of something moving in the shadows, and you tense up. You're not sure if it's safe to go any further, but you can't just turn back now. You take a deep breath and steel yourself for whatever lies ahead. As you continue to explore the cave, you can't help but feel a sense of wonder and excitement at the unknown dangers and mysteries that await you.

As you venture deeper into the cave, you are startled by a sudden glint of light. You pause, trying to figure out where it's coming from. As you move closer, you see that it's coming from a small body of water up ahead. The water is crystal clear it seemes to reflect some light, giving it a glistening appearance. You can see the shadows of fish swimming beneath the surface, and you can hear the sound of water dripping from the stalactites overhead. You approach the pond with caution, marveling at the beauty of this hidden gem. You wonder what other secrets and treasures the cave might hold.

* * *

>meditate
*** You close your eyes, feeling the power of the pond flowing through your veins.You focus on your breath and let go of all of your worries and doubts. You allow yourself to sink into a deep state of meditation, letting your mind wander freely.

You find yourself transported to a place of endless possibility, where anything is possible. You feel a sense of unity with the universe, and you understand that you are a part of something much greater than yourself. You see visions of the past and the future, and you understand that you are a link in the chain of existence.

You feel a sense of purpose and direction, and you know that you are exactly where you are meant to be. You are filled with a sense of calm and contentment, and you know that you are ready to embrace your power and your destiny. You remain in this state of meditation for what feels like an eternity, before slowly emerging back into the present moment.

You open your eyes, feeling refreshed and renewed. You realise you are where you last remembered you went to sleep. Was it all just a dream? You stand up, feeling a sense of determination and purpose. You look down and you see an amulet glistening, you don't know how this amulet was brought to you, but you have an idea... Glinda. With that in mind you are not really sure what happened but you are ready to face whatever challenges may come your way, knowing that you are stronger and wiser than ever before. ***

Would you like to RESTART, RESTORE a saved game, QUIT or UNDO the last command?

* * *

>Medros
You wake up feeling dizzy. You try to get a grasp of your surroundings

 You are in a dense forest, surrounded by tall trees and thick underbrush. It's hard to see more than a few feet in any direction. You have no idea how you ended up here, but you know you need to find your way out. The trees are tall and their leaves rustle softly in the breeze. You can hear the distant sound of a stream nearby. The air is fresh and cool, and the ground is soft beneath you. It looks like you are alone in the forest.

>w
garden
The garden is a small, overgrown patch of land located in front of the  hut. The garden is surrounded by a high, wooden fence, topped with barbed wire and warning signs. The fence serves to keep out intruders and to protect the rare and exotic plants that grow within.

The ground is thick with weeds and moss, and the air is heavy with the aroma of herbs and spices. The plants in the garden are a mishmash of medicinal and poisonous varieties, carefully tended to by someone. There are rows of medicinal herbs such as lavender, basil, and chamomile, as well as deadly nightshade, mandrake root, and henbane.

In the center of the garden is a large, ancient oak tree, its branches gnarled and twisted. The tree is said to be enchanted, and is the source of much of the witch's power. It is said that if you are brave enough to pluck a leaf from the tree, you will be granted a wish. But be warned, you get the feeling something is fiercely protective of  garden and will not hesitate to dispose anyone who tries to harm it.

Overall, the  garden is a mysterious and dangerous place, filled with secrets and magic. It is a place to be respected and feared, but also one of great power and potential.

The mysterious vine door stands at the entrance of the hut.

Nero gazes upon you with his piercing green eyes, smirking.

>e
forest
You are in a dense forest, surrounded by tall trees and thick underbrush. It's hard to see more than a few feet in any direction. You have no idea how you ended up here, but you know you need to find your way out. The trees are tall and their leaves rustle softly in the breeze. You can hear the distant sound of a stream nearby. The air is fresh and cool, and the ground is soft beneath you. It looks like you are alone in the forest.

>s
ravine
You make your way down into a deep ravine, where you find a babbling brook running through the bottom. The water looks clear and cool, and you're tempted to take a drink. You notice a small cave on the other side of the ravine, which might be worth exploring.

The babbling brook runs through the bottom of the ravine, its clear, cool water inviting you to take a drink. You see small fish swimming through the water and hear the soothing sound of the flowing stream.

You can see a Female Otter here.

The female otter swims up to you and looks at you with curious eyes. She seems to be trying to communicate something to you, and you get the feeling that she wants you to follow her.

>follow otter
By follow the otter You find an abandoned camp.

The Abandoned Camp is a desolate and eerie place, filled with the ghosts of the past. The camp consists of several dilapidated tents, their fabric torn and faded by the harsh elements. A few rickety wooden crates are scattered around the camp, their contents long since looted by scavengers. A campfire sits in the center of the camp, its ashes cold and lifeless. The only sounds are the howling wind and the creaking of the tents in the gusts.

As you explore the camp, you can't help but feel a sense of sadness and despair. It's clear that the former occupants of the camp were struggling to survive, and their fate remains a mystery. You wonder what brought them to this isolated and inhospitable place, and what ultimately caused them to abandon it. Despite the feeling of foreboding that hangs in the air, you can't shake the sense that there must be something of value hidden in the camp, waiting to be discovered.

 As you search through the abandoned camp following the otter, you notice a coiled alpine rope lying next to one of the rickety wooden crates. The rope appears to be in good condition, despite being left out in the elements for who knows how long. You wonder if it might come in handy during your exploration of the ravine.

As you finish your search, the female otter disappears into the brook, her dark fur blending in with the water as she swims away. You feel thankful, not being sure why did she help yout out.

>n
forest
You are in a dense forest, surrounded by tall trees and thick underbrush. It's hard to see more than a few feet in any direction. You have no idea how you ended up here, but you know you need to find your way out. The trees are tall and their leaves rustle softly in the breeze. You can hear the distant sound of a stream nearby. The air is fresh and cool, and the ground is soft beneath you. It looks like you are alone in the forest.

>n
The cliff rises up before you, its rocky face sheer and imposing. It looks impossible to scale without proper equipment. Luckily you got the alpine rope from the ravine. You throw it up, like magic the rope extends to the farthest cliff and attaches itself. This rope is no ordinary rope, as you stand in awe as the rope is tightly secured, this must be witches work you think to yourself before gripping the rope and starting the mounmental climb

You can feel the sweat dripping down your face as you pull yourself up the mountain, the rough rock face scraping against your fingertips. Your muscles are burning with the effort of hauling yourself up, inch by inch. You glance down at the rope that anchors you to the mountain, a thin lifeline in this vast expanse of stone and ice.

The wind howls around you, whipping your hair into your face and biting through your layers of clothing. You clench your jaw and keep climbing, determined to reach the peak that beckons above you.

Every step is a struggle, your legs shaking with the effort of supporting your weight on the narrow ledges and handholds. But you don't give up, even when your hands are numb with cold and your breath comes in ragged gasps.

At last, you reach the top and collapse onto the snowy summit, your chest heaving with the exertion of the climb. It's a feeling of exhilaration and exhaustion all at once, the sense of accomplishment washing over you as you bask in the glory of the view.

But as you look out at the dizzying expanse below, you know that the struggle to reach this peak was worth it, and you can't wait to tackle the next challenge that comes your way.

mountain peak
This is the top of a mountain peak, where you have a breathtaking view of the surrounding landscape.  The golden sunset paints the sky in a dazzling array of orange, pink, and yellow hues, casting a warm glow over the landscape. As the sun dips below the horizon, the colors intensify, creating a breathtaking spectacle that fills the sky with a riot of color. You can see for miles in every direction, but unfortunately you don't recognize any of it. You'll need to find your way down and continue searching for a way out of the woods.

The cherry blossom tree stands tall in the middle of the mountain peak with all it's beauty, you might want to check it out.

* * *

>pick cherries
Taken.

>eat one cherry
(Beautiful Cherry)
As you bite into the cherry, you feel a burst of sweetness flood your mouth. The juice is like ambrosia, nourishing and revitalizing you with each swallow. You feel a sense of strength and energy coursing through your veins, as if you could climb the mountain a hundred times and not feel the slightest bit of fatigue.

You finish the cherry and toss the pit aside, feeling a sense of renewal wash over you. You are ready to tackle the mountain again, to climb to the peak and conquer the challenges that lie ahead. The cherry has given you the strength and determination to succeed, and you know that you can do anything you set your mind to.

You toss the cherry pit aside, watching as it tumbles through the air and lands on the ground. But as you look on in amazement, something strange begins to happen. The wind picks up, blowing a shower of cherry blossom petals from the tree above. The petals twist and twirl around the cherry pit, forming a swirling mass of white and black. And then, in a matter of seconds, a beautiful orchid blooms from the cherry pit, its white petals stark against the dark, velvety center.

You stare in awe at the orchid, marveling at the way it appeared out of nowhere. The flower seems to pulsate with a magical energy, as if it were alive and breathing. You can't help but feel a sense of wonder and amazement at the sight, knowing that you have witnessed something truly special and extraordinary. The orchid is a symbol of beauty and magic, a reminder of the wonders that can be found in the world around us.

>pick flower
You can't see any such thing.

* * *

>s
forest
You are in a dense forest, surrounded by tall trees and thick underbrush. It's hard to see more than a few feet in any direction. You have no idea how you ended up here, but you know you need to find your way out. The trees are tall and their leaves rustle softly in the breeze. You can hear the distant sound of a stream nearby. The air is fresh and cool, and the ground is soft beneath you. It looks like you are alone in the forest.

>w
garden
The garden is a small, overgrown patch of land located in front of the  hut. The garden is surrounded by a high, wooden fence, topped with barbed wire and warning signs. The fence serves to keep out intruders and to protect the rare and exotic plants that grow within.

The ground is thick with weeds and moss, and the air is heavy with the aroma of herbs and spices. The plants in the garden are a mishmash of medicinal and poisonous varieties, carefully tended to by someone. There are rows of medicinal herbs such as lavender, basil, and chamomile, as well as deadly nightshade, mandrake root, and henbane.

In the center of the garden is a large, ancient oak tree, its branches gnarled and twisted. The tree is said to be enchanted, and is the source of much of the witch's power. It is said that if you are brave enough to pluck a leaf from the tree, you will be granted a wish. But be warned, you get the feeling something is fiercely protective of  garden and will not hesitate to dispose anyone who tries to harm it.

Overall, the  garden is a mysterious and dangerous place, filled with secrets and magic. It is a place to be respected and feared, but also one of great power and potential.

The mysterious vine door stands at the entrance of the hut.

Nero gazes upon you with his piercing green eyes, smirking.

>w
(first opening the mysterious vine door)
As you approach the massive vine door, the thick tendrils coiling and writhing as if alive, you can't help but feel a sense of mystery and danger emanating from it. The vines are so dense that you can't see what lies beyond them, adding to the sense of uncertainty.

You reach out tentatively to touch the vines, and they seem to pulse and writhe under your fingers. It's as if they are trying to communicate something to you, but you can't decipher their message.

Despite the eerie feeling that surrounds the vine door, you can't shake the feeling that there is something important waiting for you on the other side. You pull out the magical white orchid flower that you obtained earlier and hold it up to the vines.

To your surprise, the vines immediately calm and stop writhing. The dense foliage begins to part, revealing a small opening that you can just fit through.

Before going to the other side of the door however, you are greeted by a stunning sight. The sun is rising over the horizon, casting a warm glow over the entire forest. The trees and plants in the garden and the whole forest seems to come alive, shining and shimmering in the morning light.

You stand there for a moment, marveling at the beauty of it all. It's as if the mysterious vine door was the key to unlocking a hidden world, full of magic and wonder.

You take a deep breath and step through the opening, feeling a sense of anticipation and excitement wash over you as you wonder what lies ahead.

>w
(first opening the mysterious vine door)

hut
The hut is small and cozy, with thick stone walls that keep out the cold. A fire is crackling in the fireplace, and a large cauldron is boiling away on top of it, sending thick plumes of steam into the air. The smell of herbs and spices fills the room, and you can see a variety of strange and mystical objects scattered throughout the space. There are shelves lined with old leather-bound books, crystals and gemstones, and various alchemy equipment like beakers, flasks, and Bunsen burners. In the corner, there's a workbench covered in papers and diagrams, with a microscope and a set of delicate instruments. The hut feels like a place of magic and mystery, and you can't help but wonder what secrets it holds.

The mysterious vine door stands at the entrance of the hut.

Cauldron is on top of the fireplace. It is boiling something.

>up
Library

>s
You can't go that way.

>down
hut
The hut is small and cozy, with thick stone walls that keep out the cold. A fire is crackling in the fireplace, and a large cauldron is boiling away on top of it, sending thick plumes of steam into the air. The smell of herbs and spices fills the room, and you can see a variety of strange and mystical objects scattered throughout the space. There are shelves lined with old leather-bound books, crystals and gemstones, and various alchemy equipment like beakers, flasks, and Bunsen burners. In the corner, there's a workbench covered in papers and diagrams, with a microscope and a set of delicate instruments. The hut feels like a place of magic and mystery, and you can't help but wonder what secrets it holds.

The mysterious vine door stands at the entrance of the hut.

Cauldron is on top of the fireplace. It is boiling something.

>examinee cauldron
That's not a verb I recognise.

>examine cauldron
You see bubbling greenish water

* * *

>look cauldron
You see bubbling greenish water

>pick book
You have more important things to do right now than fiddle with every little thing in the hut, you have a feeling that you will know when you find a right thing, everything to this point lead you to this hut.

>pick random
You can't see any such thing.

* * *

Lost in the Woods
Escape the Woods by Goran Filini?
Release 1 / Serial number 230109 / Inform 7 v10.1.2 / D

forest
You are in a dense forest, surrounded by tall trees and thick underbrush. It's hard to see more than a few feet in any direction. The trees are tall and their leaves rustle softly in the breeze. You can hear the distant sound of a stream nearby. The air is fresh and cool, and the ground is soft beneath you. It looks like you are alone in the forest.

What is your name?

>Nemo
You wake up feeling dizzy. You try to get a grasp of your surroundings That's not a verb I recognise.

>n
The cliff rises up before you, its rocky face sheer and imposing. It looks impossible to scale without proper equipment.

* * *

>Nemo
You wake up feeling dizzy. You try to get a grasp of your surroundings That's not a verb I recognise.

>s
The female otter swims up to you and looks at you with curious eyes. She seems to be trying to communicate something to you, and you get the feeling that she wants you to search the ravine for something.

ravine
You make your way down into a deep ravine, where you find a babbling brook running through the bottom. The water looks clear and cool, and you're tempted to take a drink. You notice a small cave on the other side of the ravine, which might be worth exploring.

The babbling brook runs through the bottom of the ravine, its clear, cool water inviting you to take a drink. You see small fish swimming through the water and hear the soothing sound of the flowing stream.

You can see a Female Otter here.

>search
(the Female Otter)
You find nothing of interest.

>search
(the Female Otter)
You find nothing of interest.

>look
ravine
You make your way down into a deep ravine, where you find a babbling brook running through the bottom. The water looks clear and cool, and you're tempted to take a drink. You notice a small cave on the other side of the ravine, which might be worth exploring.

The babbling brook runs through the bottom of the ravine, its clear, cool water inviting you to take a drink. You see small fish swimming through the water and hear the soothing sound of the flowing stream.

You can see a Female Otter here.

* * *

>search ravine
You can't see any such thing.

>search
(the Female Otter)
You find nothing of interest.

>n
forest
You are standing in a dense forest, surrounded by tall trees and thick underbrush. It's hard to see more than a few feet in any direction. You have no idea how you ended up here, but you know you need to find your way out.

>search
What do you want to search?

>anything
You can't see any such thing.

>w
garden
The garden is a small, overgrown patch of land located in front of the  hut. The garden is surrounded by a high, wooden fence, topped with barbed wire and warning signs. The fence serves to keep out intruders and to protect the rare and exotic plants that grow within.

The ground is thick with weeds and moss, and the air is heavy with the aroma of herbs and spices. The plants in the garden are a mishmash of medicinal and poisonous varieties, carefully tended to by someone. There are rows of medicinal herbs such as lavender, basil, and chamomile, as well as deadly nightshade, mandrake root, and henbane.

In the center of the garden is a large, ancient oak tree, its branches gnarled and twisted. The tree is said to be enchanted, and is the source of much of the witch's power. It is said that if you are brave enough to pluck a leaf from the tree, you will be granted a wish. But be warned, you get the feeling something is fiercely protective of  garden and will not hesitate to dispose anyone who tries to harm it.

Overall, the  garden is a mysterious and dangerous place, filled with secrets and magic. It is a place to be respected and feared, but also one of great power and potential.

The mysterious vine door prevents you from entering the hut, maybe the piercing green eyed cat can help you enter, you think to yourself.

Nero gazes upon you with his piercing green eyes, smirking.

>serach
That's not a verb I recognise.

>search
What do you want to search?

>Nero
You find nothing of interest.

>search rope
You can't see any such thing.

>s
You can't go that way.

>e
forest
You are standing in a dense forest, surrounded by tall trees and thick underbrush. It's hard to see more than a few feet in any direction. You have no idea how you ended up here, but you know you need to find your way out.

>s
The female otter swims up to you and looks at you with curious eyes. She seems to be trying to communicate something to you, and you get the feeling that she wants you to search the ravine for something.

>serach the ravine
That's not a verb I recognise.

>search the ravine
You can't see any such thing.

>search
(the Female Otter)
You find nothing of interest.

I beg your pardon?

* * *

>Nemo
You wake up feeling dizzy. You try to get a grasp of your surroundings That's not a verb I recognise.

>w
garden
The garden is a small, overgrown patch of land located in front of the  hut. The garden is surrounded by a high, wooden fence, topped with barbed wire and warning signs. The fence serves to keep out intruders and to protect the rare and exotic plants that grow within.

The ground is thick with weeds and moss, and the air is heavy with the aroma of herbs and spices. The plants in the garden are a mishmash of medicinal and poisonous varieties, carefully tended to by someone. There are rows of medicinal herbs such as lavender, basil, and chamomile, as well as deadly nightshade, mandrake root, and henbane.

In the center of the garden is a large, ancient oak tree, its branches gnarled and twisted. The tree is said to be enchanted, and is the source of much of the witch's power. It is said that if you are brave enough to pluck a leaf from the tree, you will be granted a wish. But be warned, you get the feeling something is fiercely protective of  garden and will not hesitate to dispose anyone who tries to harm it.

Overall, the  garden is a mysterious and dangerous place, filled with secrets and magic. It is a place to be respected and feared, but also one of great power and potential.

The mysterious vine door prevents you from entering the hut, maybe the piercing green eyed cat can help you enter, you think to yourself.

Nero gazes upon you with his piercing green eyes, smirking.

>ask nero about cliff
Nero: This is a part of your challenge, you will have to look for something that will aid you in your quest. I suggest searching the ravine for something, who knows what the river washed out

>ask nero about wheather
There is no reply.

* * *

>ask nero about the weathe
I'm sorry Nemo, this is not something I help you with!

* * *

>ask nero about wheather
There is no reply.

* * *

Lost in the Woods
Escape the Woods by Goran Filini?
Release 1 / Serial number 230109 / Inform 7 v10.1.2 / D

forest
You are in a dense forest, surrounded by tall trees and thick underbrush. It's hard to see more than a few feet in any direction. The trees are tall and their leaves rustle softly in the breeze. You can hear the distant sound of a stream nearby. The air is fresh and cool, and the ground is soft beneath you. It looks like you are alone in the forest.

What is your name?

>Niko
You wake up feeling dizzy. You try to get a grasp of your surroundings That's not a verb I recognise.

>Niko
You wake up feeling dizzy. You try to get a grasp of your surroundings That's not a verb I recognise.

What is your name?

* * *

>Niko
You wake up feeling dizzy. You try to get a grasp of your surroundings That's not a verb I recognise.

>s
ravine
You make your way down into a deep ravine, where you find a babbling brook running through the bottom. The water looks clear and cool, and you're tempted to take a drink. You notice a small cave on the other side of the ravine, which might be worth exploring.

>n
forest
You are standing in a dense forest, surrounded by tall trees and thick underbrush. It's hard to see more than a few feet in any direction. You have no idea how you ended up here, but you know you need to find your way out.

>w
garden
The garden is a small, overgrown patch of land located in front of the  hut. The garden is surrounded by a high, wooden fence, topped with barbed wire and warning signs. The fence serves to keep out intruders and to protect the rare and exotic plants that grow within.

The ground is thick with weeds and moss, and the air is heavy with the aroma of herbs and spices. The plants in the garden are a mishmash of medicinal and poisonous varieties, carefully tended to by someone. There are rows of medicinal herbs such as lavender, basil, and chamomile, as well as deadly nightshade, mandrake root, and henbane.

In the center of the garden is a large, ancient oak tree, its branches gnarled and twisted. The tree is said to be enchanted, and is the source of much of the witch's power. It is said that if you are brave enough to pluck a leaf from the tree, you will be granted a wish. But be warned, you get the feeling something is fiercely protective of  garden and will not hesitate to dispose anyone who tries to harm it.

Overall, the  garden is a mysterious and dangerous place, filled with secrets and magic. It is a place to be respected and feared, but also one of great power and potential.

The mysterious vine door prevents you from entering the hut, maybe the piercing green eyed cat can help you enter, you think to yourself.

Nero gazes upon you with his piercing green eyes, smirking.

>Talk to Nero
Niko: Who are you? How did you get in here?

 Nero: I am Nero, a magical feline with the ability to teleport. I have been watching you for some time. The witch wants to keep an out on you.

Niko: I'm just trying to get to the hut, I didn't know this was witches, but there's a vine door blocking my way. Do you know how I can get through it?

Nero: Ah, the vine door. It can only be unlocked with a special flower. But this flower does not grow in the garden. It can only be found on the mountain peak, high above the clouds.

* * *

Lost in the Woods
Escape the Woods by Goran Filini?
Release 1 / Serial number 230109 / Inform 7 v10.1.2 / D

forest
You are in a dense forest, surrounded by tall trees and thick underbrush. It's hard to see more than a few feet in any direction. The trees are tall and their leaves rustle softly in the breeze. You can hear the distant sound of a stream nearby. The air is fresh and cool, and the ground is soft beneath you. It looks like you are alone in the forest.

What is your name?

>Tekko
You wake up feeling dizzy. You try to get a grasp of your surroundings That's not a verb I recognise.

>s
ravine
You make your way down into a deep ravine, where you find a babbling brook running through the bottom. The water looks clear and cool, and you're tempted to take a drink. You notice a small cave on the other side of the ravine, which might be worth exploring.

The babbling brook runs through the bottom of the ravine, its clear, cool water inviting you to take a drink. You see small fish swimming through the water and hear the soothing sound of the flowing stream.

You can see a Female Otter here.

The female otter swims up to you and looks at you with curious eyes. She seems to be trying to communicate something to you, and you get the feeling that she wants you to follow her.

>Follow female otter
By follow the otter You find an abandoned camp.

The Abandoned Camp is a desolate and eerie place, filled with the ghosts of the past. The camp consists of several dilapidated tents, their fabric torn and faded by the harsh elements. A few rickety wooden crates are scattered around the camp, their contents long since looted by scavengers. A campfire sits in the center of the camp, its ashes cold and lifeless. The only sounds are the howling wind and the creaking of the tents in the gusts.

As you explore the camp, you can't help but feel a sense of sadness and despair. It's clear that the former occupants of the camp were struggling to survive, and their fate remains a mystery. You wonder what brought them to this isolated and inhospitable place, and what ultimately caused them to abandon it. Despite the feeling of foreboding that hangs in the air, you can't shake the sense that there must be something of value hidden in the camp, waiting to be discovered.

 As you search through the abandoned camp following the otter, you notice a coiled alpine rope lying next to one of the rickety wooden crates. The rope appears to be in good condition, despite being left out in the elements for who knows how long. You wonder if it might come in handy during your exploration of the ravine.

As you finish your search, the female otter disappears into the brook, her dark fur blending in with the water as she swims away. You feel thankful, not being sure why did she help yout out.

>n
forest
You are standing in a dense forest, surrounded by tall trees and thick underbrush. It's hard to see more than a few feet in any direction. You have no idea how you ended up here, but you know you need to find your way out.

* * *

>s
ravine
You make your way down into a deep ravine, where you find a babbling brook running through the bottom. The water looks clear and cool, and you're tempted to take a drink. You notice a small cave on the other side of the ravine, which might be worth exploring.

The babbling brook runs through the bottom of the ravine, its clear, cool water inviting you to take a drink. You see small fish swimming through the water and hear the soothing sound of the flowing stream.

There is also an abandoned camp that you found earlier

>n
forest
You are standing in a dense forest, surrounded by tall trees and thick underbrush. It's hard to see more than a few feet in any direction. You have no idea how you ended up here, but you know you need to find your way out.

* * *

>look
mountain peak
This is the top of a mountain peak, where you have a breathtaking view of the surrounding landscape.  The golden sunset paints the sky in a dazzling array of orange, pink, and yellow hues, casting a warm glow over the landscape. As the sun dips below the horizon, the colors intensify, creating a breathtaking spectacle that fills the sky with a riot of color. You can see for miles in every direction, but unfortunately you don't recognize any of it. You'll need to find your way down and continue searching for a way out of the woods.

The cherry blossom tree stands tall in the middle of the mountain peak with all it's beauty, you might want to check it out.

>examine Cherry Blossom Tree
The cherry blossom tree stands tall on the mountain peak, its branches heavy with delicate pink flowers. The petals are a blur of color against the bright blue sky, each one a perfect, fragrant masterpiece. The breeze stirs the branches, sending a shower of petals swirling around you like confetti.

The cherries themselves are small and round, their skin a glossy red that seems to glow in the sunlight. You can't resist reaching out to pluck one from the branch, the juice bursting against your tongue as you bite into its sweet, tender flesh.

The scent of the cherry blossoms is intoxicating, filling the air with a heady aroma that is at once floral and fruity. You close your eyes and take a deep breath, feeling the stress of the world melting away as you bask in the beauty of the tree.

As you stand there, surrounded by the cherry blossom tree's graceful branches and fragrant flowers, you can't help but feel a sense of peace and contentment wash over you. It's a moment of pure, unadulterated joy, one that you know you'll always treasure.

In the Cherry Blossom Tree is Beautiful Cherry.

>Take Cherries
You can't see any such thing.

>eat cherries
You can't see any such thing.

>s
forest
You are standing in a dense forest, surrounded by tall trees and thick underbrush. It's hard to see more than a few feet in any direction. You have no idea how you ended up here, but you know you need to find your way out.

* * *

>Talk to Nero
Tekko: Who are you? How did you get in here?

 Nero: I am Nero, a magical feline with the ability to teleport. I have been watching you for some time. The witch wants to keep an eye out on you.

(nero laughs smirkly)Tekko: I'm just trying to get to the hut to find some supplies, I didn't know this was witches, but there's a vine door blocking my way. Do you know how I can get through it?

Nero: Ah,  your first test is the vine door. It can only be unlocked with a special flower. But this flower does not grow in the garden. It can only be found on the mountain peak, high above the clouds.

Nero: Oh and another thing, I will be your guide for this trial, if you ever fill stuck just ask me "What now?"

>e
forest
You are standing in a dense forest, surrounded by tall trees and thick underbrush. It's hard to see more than a few feet in any direction. You have no idea how you ended up here, but you know you need to find your way out.

>n
The cliff rises up before you, its rocky face sheer and imposing. It looks impossible to scale without proper equipment. Luckily you got the alpine rope from the ravine. You throw it up, like magic the rope extends to the farthest cliff and attaches itself. This rope is no ordinary rope, as you stand in awe as the rope is tightly secured, this must be witches work you think to yourself before gripping the rope and starting the mounmental climb

You can feel the sweat dripping down your face as you pull yourself up the mountain, the rough rock face scraping against your fingertips. Your muscles are burning with the effort of hauling yourself up, inch by inch. You glance down at the rope that anchors you to the mountain, a thin lifeline in this vast expanse of stone and ice.

The wind howls around you, whipping your hair into your face and biting through your layers of clothing. You clench your jaw and keep climbing, determined to reach the peak that beckons above you.

Every step is a struggle, your legs shaking with the effort of supporting your weight on the narrow ledges and handholds. But you don't give up, even when your hands are numb with cold and your breath comes in ragged gasps.

At last, you reach the top and collapse onto the snowy summit, your chest heaving with the exertion of the climb. It's a feeling of exhilaration and exhaustion all at once, the sense of accomplishment washing over you as you bask in the glory of the view.

But as you look out at the dizzying expanse below, you know that the struggle to reach this peak was worth it, and you can't wait to tackle the next challenge that comes your way.

mountain peak
This is the top of a mountain peak, where you have a breathtaking view of the surrounding landscape.  The golden sunset paints the sky in a dazzling array of orange, pink, and yellow hues, casting a warm glow over the landscape. As the sun dips below the horizon, the colors intensify, creating a breathtaking spectacle that fills the sky with a riot of color. You can see for miles in every direction, but unfortunately you don't recognize any of it. What worries you is that you don't see the flower which Nero mention.

What you do see however is the cherry blossom tree that stands tall in the middle of the mountain peak with all it's beauty, you might want to check it out.

>examine Cherry blossom tree
The cherry blossom tree stands tall on the mountain peak, its branches heavy with delicate pink flowers. The petals are a blur of color against the bright blue sky, each one a perfect, fragrant masterpiece. The breeze stirs the branches, sending a shower of petals swirling around you like confetti.

The cherries themselves are small and round, their skin a glossy red that seems to glow in the sunlight. You can't resist reaching out to pluck one from the branch, the juice bursting against your tongue as you bite into its sweet, tender flesh.

The scent of the cherry blossoms is intoxicating, filling the air with a heady aroma that is at once floral and fruity. You close your eyes and take a deep breath, feeling the stress of the world melting away as you bask in the beauty of the tree.

As you stand there, surrounded by the cherry blossom tree's graceful branches and fragrant flowers, you can't help but feel a sense of peace and contentment wash over you. It's a moment of pure, unadulterated joy, one that you know you'll always treasure.

In the Cherry Blossom Tree is Beautiful Cherry.

>take Cherry
(Beautiful Cherry)
Taken.

>eat Cherry
(Beautiful Cherry)
As you bite into the cherry, you feel a burst of sweetness flood your mouth. The juice is like ambrosia, nourishing and revitalizing you with each swallow. You feel a sense of strength and energy coursing through your veins, as if you could climb the mountain a hundred times and not feel the slightest bit of fatigue.

You finish the cherry and toss the pit aside, feeling a sense of renewal wash over you. You are ready to tackle the mountain again, to climb to the peak and conquer the challenges that lie ahead. The cherry has given you the strength and determination to succeed, and you know that you can do anything you set your mind to.

You toss the cherry pit aside, watching as it tumbles through the air and lands on the ground. But as you look on in amazement, something strange begins to happen. The wind picks up, blowing a shower of cherry blossom petals from the tree above. The petals twist and twirl around the cherry pit, forming a swirling mass of white and black. And then, in a matter of seconds, a beautiful orchid blooms from the cherry pit, its white petals stark against the dark, velvety center.

You stare in awe at the orchid, marveling at the way it appeared out of nowhere. The flower seems to pulsate with a magical energy, as if it were alive and breathing. You can't help but feel a sense of wonder and amazement at the sight, knowing that you have witnessed something truly special and extraordinary. The orchid is a symbol of beauty and magic, a reminder of the wonders that can be found in the world around us.

>look
mountain peak
This is the top of a mountain peak, where you have a breathtaking view of the surrounding landscape.  The golden sunset paints the sky in a dazzling array of orange, pink, and yellow hues, casting a warm glow over the landscape. As the sun dips below the horizon, the colors intensify, creating a breathtaking spectacle that fills the sky with a riot of color. You can see for miles in every direction, but unfortunately you don't recognize any of it. What you do see however is the cherry blossom tree that stands tall in the middle of the mountain peak with all it's beauty, remainding you of the whole experience with the climb and orchid

You can see Magical white Orchid here.

>take Magical white orchid
Taken.

>drop magical white orchid
Dropped.

>look
mountain peak
This is the top of a mountain peak, where you have a breathtaking view of the surrounding landscape.  The golden sunset paints the sky in a dazzling array of orange, pink, and yellow hues, casting a warm glow over the landscape. As the sun dips below the horizon, the colors intensify, creating a breathtaking spectacle that fills the sky with a riot of color. You can see for miles in every direction, but unfortunately you don't recognize any of it. What you do see however is the cherry blossom tree that stands tall in the middle of the mountain peak with all it's beauty, remainding you of the whole experience with the climb and orchid

You can see Magical white Orchid here.

>pick orchid
Taken.

>pick magical white orchid
You already have that.

* * *

>Follow the otter
You find an abandoned campThe Abandoned Camp is a desolate and eerie place, filled with the ghosts of the past. The camp consists of several dilapidated tents, their fabric torn and faded by the harsh elements. A few rickety wooden crates are scattered around the camp, their contents long since looted by scavengers. A campfire sits in the center of the camp, its ashes cold and lifeless. The only sounds are the howling wind and the creaking of the tents in the gusts.

As you explore the camp, you can't help but feel a sense of sadness and despair. It's clear that the former occupants of the camp were struggling to survive, and their fate remains a mystery. You wonder what brought them to this isolated and inhospitable place, and what ultimately caused them to abandon it. Despite the feeling of foreboding that hangs in the air, you can't shake the sense that there must be something of value hidden in the camp, waiting to be discovered.

* * *

>follow Female Otter
That's not a verb I recognise.

>follow the Female Otter
That's not a verb I recognise.

* * *

>follow the Female Otter
You find an abandoned camp

* * *

>follow the otter
By follow the otter You find an abandoned camp.

The Abandoned Camp is a desolate and eerie place, filled with the ghosts of the past. The camp consists of several dilapidated tents, their fabric torn and faded by the harsh elements. A few rickety wooden crates are scattered around the camp, their contents long since looted by scavengers. A campfire sits in the center of the camp, its ashes cold and lifeless. The only sounds are the howling wind and the creaking of the tents in the gusts.

As you explore the camp, you can't help but feel a sense of sadness and despair. It's clear that the former occupants of the camp were struggling to survive, and their fate remains a mystery. You wonder what brought them to this isolated and inhospitable place, and what ultimately caused them to abandon it. Despite the feeling of foreboding that hangs in the air, you can't shake the sense that there must be something of value hidden in the camp, waiting to be discovered.

 As you search through the abandoned camp following the otter, you notice a coiled alpine rope lying next to one of the rickety wooden crates. The rope appears to be in good condition, despite being left out in the elements for who knows how long. You wonder if it might come in handy during your exploration of the ravine.

As you finish your search, the female otter disappears into the brook, her dark fur blending in with the water as she swims away. You feel thankful, not being sure why did she help yout out.

>N
forest
You are standing in a dense forest, surrounded by tall trees and thick underbrush. It's hard to see more than a few feet in any direction. You have no idea how you ended up here, but you know you need to find your way out.

>s
ravine
You make your way down into a deep ravine, where you find a babbling brook running through the bottom. The water looks clear and cool, and you're tempted to take a drink. You notice a small cave on the other side of the ravine, which might be worth exploring.

The babbling brook runs through the bottom of the ravine, its clear, cool water inviting you to take a drink. You see small fish swimming through the water and hear the soothing sound of the flowing stream.

There is also an abandoned camp that you found earlier

The female otter swims up to you and looks at you with curious eyes. She seems to be trying to communicate something to you, and you get the feeling that she wants you to follow her.

>look
ravine
You make your way down into a deep ravine, where you find a babbling brook running through the bottom. The water looks clear and cool, and you're tempted to take a drink. You notice a small cave on the other side of the ravine, which might be worth exploring.

The babbling brook runs through the bottom of the ravine, its clear, cool water inviting you to take a drink. You see small fish swimming through the water and hear the soothing sound of the flowing stream.

There is also an abandoned camp that you found earlier

The female otter swims up to you and looks at you with curious eyes. She seems to be trying to communicate something to you, and you get the feeling that she wants you to follow her.

>look female otter
You can't see any such thing.

* * *

>n
forest
You are standing in a dense forest, surrounded by tall trees and thick underbrush. It's hard to see more than a few feet in any direction. You have no idea how you ended up here, but you know you need to find your way out.

>s
ravine
You make your way down into a deep ravine, where you find a babbling brook running through the bottom. The water looks clear and cool, and you're tempted to take a drink. You notice a small cave on the other side of the ravine, which might be worth exploring.

The babbling brook runs through the bottom of the ravine, its clear, cool water inviting you to take a drink. You see small fish swimming through the water and hear the soothing sound of the flowing stream.

You can see a Female Otter here.

>loook female otter
That's not a verb I recognise.

>look female otter
A sleek and agile female otter swims through the babbling brook, her dark fur glistening in the sunlight. She seems to be searching for something, her eyes constantly scanning the surroundings.

* * *

>search
(the Female Otter)
You find nothing of interest.

* * *

>Tekko
You wake up feeling dizzy. You try to get a grasp of your surroundings That's not a verb I recognise.

>seach
That's not a verb I recognise.

>search
You must supply a noun.

>search
You must supply a noun.

>s
ravine
You make your way down into a deep ravine, where you find a babbling brook running through the bottom. The water looks clear and cool, and you're tempted to take a drink. You notice a small cave on the other side of the ravine, which might be worth exploring.

The babbling brook runs through the bottom of the ravine, its clear, cool water inviting you to take a drink. You see small fish swimming through the water and hear the soothing sound of the flowing stream.

You can see a Female Otter here.

The female otter swims up to you and looks at you with curious eyes. She seems to be trying to communicate something to you, and you get the feeling that she wants you to search the ravine for something.

>search
You must supply a noun.

>search ravine
You can't see any such thing.

>search otter
You find nothing of interest.

>search Female otter
You find nothing of interest.

* * *

>Tekko
You wake up feeling dizzy. You try to get a grasp of your surroundings That's not a verb I recognise.

>search
What do you want to search?

>not
You can't see any such thing.

I beg your pardon?

>s
ravine
You make your way down into a deep ravine, where you find a babbling brook running through the bottom. The water looks clear and cool, and you're tempted to take a drink. You notice a small cave on the other side of the ravine, which might be worth exploring.

The babbling brook runs through the bottom of the ravine, its clear, cool water inviting you to take a drink. You see small fish swimming through the water and hear the soothing sound of the flowing stream.

You can see a Female Otter here.

The female otter swims up to you and looks at you with curious eyes. She seems to be trying to communicate something to you, and you get the feeling that she wants you to search the ravine for something.

>search
(the Female Otter)
You find nothing of interest.

* * *

Lost in the Woods
Escape the Woods by Goran Filini?
Release 1 / Serial number 230109 / Inform 7 v10.1.2 / D

forest
You are in a dense forest, surrounded by tall trees and thick underbrush. It's hard to see more than a few feet in any direction. The trees are tall and their leaves rustle softly in the breeze. You can hear the distant sound of a stream nearby. The air is fresh and cool, and the ground is soft beneath you. It looks like you are alone in the forest.

What is your name?

>foorest
forest
You are standing in a dense forest, surrounded by tall trees and thick underbrush. It's hard to see more than a few feet in any direction. You have no idea how you ended up here, but you know you need to find your way out.

You wake up feeling dizzy. You try to get a grasp of your surroundings

* * *

Lost in the Woods
Escape the Woods by Goran Filini?
Release 1 / Serial number 230109 / Inform 7 v10.1.2 / D

forest
You are in a dense forest, surrounded by tall trees and thick underbrush. It's hard to see more than a few feet in any direction. The trees are tall and their leaves rustle softly in the breeze. You can hear the distant sound of a stream nearby. The air is fresh and cool, and the ground is soft beneath you. It looks like you are alone in the forest.

What is your name?

>s
You wake up feeling dizzy. You try to get a grasp of your surroundings 
ravine
You make your way down into a deep ravine, where you find a babbling brook running through the bottom. The water looks clear and cool, and you're tempted to take a drink. You notice a small cave on the other side of the ravine, which might be worth exploring.

The babbling brook runs through the bottom of the ravine, its clear, cool water inviting you to take a drink. You see small fish swimming through the water and hear the soothing sound of the flowing stream.

You can see a Female Otter here.

The female otter swims up to you and looks at you with curious eyes. She seems to be trying to communicate something to you, and you get the feeling that she wants you to follow her.

>down
You cannot enter the cave, it's too dark in there!

>n
forest
You are standing in a dense forest, surrounded by tall trees and thick underbrush. It's hard to see more than a few feet in any direction. You have no idea how you ended up here, but you know you need to find your way out.

>left
That's not a verb I recognise.

>w
garden
The garden is a small, overgrown patch of land located in front of the  hut. The garden is surrounded by a high, wooden fence, topped with barbed wire and warning signs. The fence serves to keep out intruders and to protect the rare and exotic plants that grow within.

The ground is thick with weeds and moss, and the air is heavy with the aroma of herbs and spices. The plants in the garden are a mishmash of medicinal and poisonous varieties, carefully tended to by someone. There are rows of medicinal herbs such as lavender, basil, and chamomile, as well as deadly nightshade, mandrake root, and henbane.

In the center of the garden is a large, ancient oak tree, its branches gnarled and twisted. The tree is said to be enchanted, and is the source of much of the witch's power. It is said that if you are brave enough to pluck a leaf from the tree, you will be granted a wish. But be warned, you get the feeling something is fiercely protective of  garden and will not hesitate to dispose anyone who tries to harm it.

Overall, the  garden is a mysterious and dangerous place, filled with secrets and magic. It is a place to be respected and feared, but also one of great power and potential.

>w
hut
You can see a lot of mystical stuff and alchemy stuff all around. There is also a fireplace

Cauldron is on top of the fireplace. It is boiling something.

>attack cauldron
You spill the hot cauldron on the floor. The whole floor is wet. You can see the from dropping from the cauldron. You try to pick it up and find that it is as cold as ice. You keep it.

>eat frozen frog
You wish you had another frozen frog.

>e
garden
The garden is a small, overgrown patch of land located in front of the  hut. The garden is surrounded by a high, wooden fence, topped with barbed wire and warning signs. The fence serves to keep out intruders and to protect the rare and exotic plants that grow within.

The ground is thick with weeds and moss, and the air is heavy with the aroma of herbs and spices. The plants in the garden are a mishmash of medicinal and poisonous varieties, carefully tended to by someone. There are rows of medicinal herbs such as lavender, basil, and chamomile, as well as deadly nightshade, mandrake root, and henbane.

In the center of the garden is a large, ancient oak tree, its branches gnarled and twisted. The tree is said to be enchanted, and is the source of much of the witch's power. It is said that if you are brave enough to pluck a leaf from the tree, you will be granted a wish. But be warned, you get the feeling something is fiercely protective of  garden and will not hesitate to dispose anyone who tries to harm it.

Overall, the  garden is a mysterious and dangerous place, filled with secrets and magic. It is a place to be respected and feared, but also one of great power and potential.

>e
forest
You are standing in a dense forest, surrounded by tall trees and thick underbrush. It's hard to see more than a few feet in any direction. You have no idea how you ended up here, but you know you need to find your way out.

>s
ravine
You make your way down into a deep ravine, where you find a babbling brook running through the bottom. The water looks clear and cool, and you're tempted to take a drink. You notice a small cave on the other side of the ravine, which might be worth exploring.

>down
cave
You approach the dark cave cautiously, trying not to make too much noise. You hear dripping water and the sound of something moving in the shadows. You're not sure if it's safe to go in, but you can't just turn back now. You take a deep breath and step into the darkness.

* * *

>follow the female otter
By follow the otter You find an abandoned camp.

The Abandoned Camp is a desolate and eerie place, filled with the ghosts of the past. The camp consists of several dilapidated tents, their fabric torn and faded by the harsh elements. A few rickety wooden crates are scattered around the camp, their contents long since looted by scavengers. A campfire sits in the center of the camp, its ashes cold and lifeless. The only sounds are the howling wind and the creaking of the tents in the gusts.

As you explore the camp, you can't help but feel a sense of sadness and despair. It's clear that the former occupants of the camp were struggling to survive, and their fate remains a mystery. You wonder what brought them to this isolated and inhospitable place, and what ultimately caused them to abandon it. Despite the feeling of foreboding that hangs in the air, you can't shake the sense that there must be something of value hidden in the camp, waiting to be discovered.

>n
forest
You are standing in a dense forest, surrounded by tall trees and thick underbrush. It's hard to see more than a few feet in any direction. You have no idea how you ended up here, but you know you need to find your way out.

>s
ravine
You make your way down into a deep ravine, where you find a babbling brook running through the bottom. The water looks clear and cool, and you're tempted to take a drink. You notice a small cave on the other side of the ravine, which might be worth exploring.

The babbling brook runs through the bottom of the ravine, its clear, cool water inviting you to take a drink. You see small fish swimming through the water and hear the soothing sound of the flowing stream.

There is also an abandoned camp that you found earlier

You can see a Female Otter here.

The female otter swims up to you and looks at you with curious eyes. She seems to be trying to communicate something to you, and you get the feeling that she wants you to follow her.

* * *

>s
You can't go that way.

>down
cave
You approach the dark cave cautiously, trying not to make too much noise. You hear dripping water and the sound of something moving in the shadows. You're not sure if it's safe to go in, but you can't just turn back now. You take a deep breath and step into the darkness.

* * *

>s
You can't go that way.

>look
ravine
You make your way down into a deep ravine, where you find a babbling brook running through the bottom. The water looks clear and cool, and you're tempted to take a drink. You notice a small cave on the other side of the ravine, which might be worth exploring.

The babbling brook runs through the bottom of the ravine, its clear, cool water inviting you to take a drink. You see small fish swimming through the water and hear the soothing sound of the flowing stream.

You can see a Female Otter here.

The female otter swims up to you and looks at you with curious eyes. She seems to be trying to communicate something to you, and you get the feeling that she wants you to follow her.

>look for abandoned camp
You can't see any such thing.

>n
forest
You are standing in a dense forest, surrounded by tall trees and thick underbrush. It's hard to see more than a few feet in any direction. You have no idea how you ended up here, but you know you need to find your way out.

* * *

>Examine oak tree
In the center of the garden is a large, ancient oak tree, its branches gnarled and twisted. The tree is said to be enchanted, and is the source of much of the witch's power. It is said that if you are brave enough to pluck a leaf from the tree, you will be granted a wish. But be warned, the witch is fiercely protective of her garden and will not hesitate to cast a spell on anyone who tries to harm it.

>e
forest
You are standing in a dense forest, surrounded by tall trees and thick underbrush. It's hard to see more than a few feet in any direction. You have no idea how you ended up here, but you know you need to find your way out.

* * *

>examine abandoned camp
The Abandoned Camp is a desolate and eerie place, filled with the ghosts of the past. The camp consists of several dilapidated tents, their fabric torn and faded by the harsh elements. A few rickety wooden crates are scattered around the camp, their contents long since looted by scavengers. A campfire sits in the center of the camp, its ashes cold and lifeless. The only sounds are the howling wind and the creaking of the tents in the gusts.

As you explore the camp, you can't help but feel a sense of sadness and despair. It's clear that the former occupants of the camp were struggling to survive, and their fate remains a mystery. You wonder what brought them to this isolated and inhospitable place, and what ultimately caused them to abandon it. Despite the feeling of foreboding that hangs in the air, you can't shake the sense that there must be something of value hidden in the camp, waiting to be discovered.

* * *

>s
You can't go that way.

>s
You can't go that way.

>n
forest
You are standing in a dense forest, surrounded by tall trees and thick underbrush. It's hard to see more than a few feet in any direction. You have no idea how you ended up here, but you know you need to find your way out.

>s
The female otter swims up to you and looks at you with curious eyes. She seems to be trying to communicate something to you, and you get the feeling that she wants you to search the ravine for something.

* * *

Lost in the Woods
Escape the Woods by Goran Filini?
Release 1 / Serial number 230109 / Inform 7 v10.1.2 / D

forest
You are in a dense forest, surrounded by tall trees and thick underbrush. It's hard to see more than a few feet in any direction. The trees are tall and their leaves rustle softly in the breeze. You can hear the distant sound of a stream nearby. The air is fresh and cool, and the ground is soft beneath you. It looks like you are alone in the forest.

What is your name?

>tekko
You wake up feeling dizzy. You try to get a grasp of your surroundings That's not a verb I recognise.

>s
ravine
You make your way down into a deep ravine, where you find a babbling brook running through the bottom. The water looks clear and cool, and you're tempted to take a drink. You notice a small cave on the other side of the ravine, which might be worth exploring.

The babbling brook runs through the bottom of the ravine, its clear, cool water inviting you to take a drink. You see small fish swimming through the water and hear the soothing sound of the flowing stream.

You can see a Female Otter here.

The female otter swims up to you and looks at you with curious eyes. She seems to be trying to communicate something to you, and you get the feeling that she wants you to search the ravine for something.

>search ravine
You can't see any such thing.

* * *

>search
(the Female Otter)
You find nothing of interest.

>searching
That's not a verb I recognise.

* * *

Lost in the Woods
Escape the Woods by Goran Filini?
Release 1 / Serial number 230109 / Inform 7 v10.1.2 / D

forest
You are in a dense forest, surrounded by tall trees and thick underbrush. It's hard to see more than a few feet in any direction. The trees are tall and their leaves rustle softly in the breeze. You can hear the distant sound of a stream nearby. The air is fresh and cool, and the ground is soft beneath you. It looks like you are alone in the forest.

What is your name?

>w
garden
The garden is a small, overgrown patch of land located in front of the  hut. The garden is surrounded by a high, wooden fence, topped with barbed wire and warning signs. The fence serves to keep out intruders and to protect the rare and exotic plants that grow within.

The ground is thick with weeds and moss, and the air is heavy with the aroma of herbs and spices. The plants in the garden are a mishmash of medicinal and poisonous varieties, carefully tended to by someone. There are rows of medicinal herbs such as lavender, basil, and chamomile, as well as deadly nightshade, mandrake root, and henbane.

In the center of the garden is a large, ancient oak tree, its branches gnarled and twisted. The tree is said to be enchanted, and is the source of much of the witch's power. It is said that if you are brave enough to pluck a leaf from the tree, you will be granted a wish. But be warned, you get the feeling something is fiercely protective of  garden and will not hesitate to dispose anyone who tries to harm it.

Overall, the  garden is a mysterious and dangerous place, filled with secrets and magic. It is a place to be respected and feared, but also one of great power and potential.

The mysterious vine door prevents you from entering the hut, maybe the piercing green eyed cat can help you enter, you think to yourself.

Nero gazes upon you with his piercing green eyes, smirking.

I beg your pardon?

>w
hut
You can see a lot of mystical stuff and alchemy stuff all around. There is also a fireplace

You can see Cauldron (closed) here.

>open
(Cauldron)
You open Cauldron, revealing a liquid.

>drink liquid
There's nothing suitable to drink here.

>drink cauldron
There's nothing suitable to drink here.

>eat liquid
That's plainly inedible.

* * *

>e
forest
You are standing in a dense forest, surrounded by tall trees and thick underbrush. It's hard to see more than a few feet in any direction. You have no idea how you ended up here, but you know you need to find your way out.

>e
thicket
You push your way through a thicket of trees and underbrush, scratching your arms and legs on the rough branches. You hear rustling in the bushes and turn to see a pair of glowing eyes staring back at you. You're not sure what kind of animal it is, but you don't want to stick around to find out.

>s
You can't go that way.

>w
forest
You are standing in a dense forest, surrounded by tall trees and thick underbrush. It's hard to see more than a few feet in any direction. You have no idea how you ended up here, but you know you need to find your way out.

>s
ravine
You make your way down into a deep ravine, where you find a babbling brook running through the bottom. The water looks clear and cool, and you're tempted to take a drink. You notice a small cave on the other side of the ravine, which might be worth exploring.

* * *

>n
forest
You are standing in a dense forest, surrounded by tall trees and thick underbrush. It's hard to see more than a few feet in any direction. You have no idea how you ended up here, but you know you need to find your way out.

>n
mountain peak
You climb to the top of a mountain peak, where you have a breathtaking view of the surrounding landscape. You can see for miles in every direction, but unfortunately you don't recognize any of it. You'll need to find your way down and continue searching for a way out of the woods.

>down
You can't go that way.

>s
forest
You are standing in a dense forest, surrounded by tall trees and thick underbrush. It's hard to see more than a few feet in any direction. You have no idea how you ended up here, but you know you need to find your way out.

>s
ravine
You make your way down into a deep ravine, where you find a babbling brook running through the bottom. The water looks clear and cool, and you're tempted to take a drink. You notice a small cave on the other side of the ravine, which might be worth exploring.

* * *

>down
cave
You approach the dark cave cautiously, trying not to make too much noise. You hear dripping water and the sound of something moving in the shadows. You're not sure if it's safe to go in, but you can't just turn back now. You take a deep breath and step into the darkness.

>n
You can't go that way.

>up
ravine
You make your way down into a deep ravine, where you find a babbling brook running through the bottom. The water looks clear and cool, and you're tempted to take a drink. You notice a small cave on the other side of the ravine, which might be worth exploring.

* * *

>examine
What do you want to examine?

>vine door
A massive vine door blocks the passage, its thick tendrils coiling and writhing as if alive. The vines are so dense that you can't see what lies beyond them, adding to the sense of mystery and danger.

You reach out tentatively to touch the vines, and they seem to pulse and writhe under your fingers. It's as if they are trying to communicate something to you, but you can't decipher their message.

Despite the eerie feeling that surrounds the vine door, you can't help but feel drawn to it. You have a sense that there is something important waiting for you on the other side, something that could change your life forever.

You see nothing special about the mysterious vine door.

* * *

>examine mysterious vine door
You see nothing special about the mysterious vine door.

>look mysterious vine door
You see nothing special about the mysterious vine door.

>look nero
Nero is a sleek, black feline with piercing green eyes. He is the loyal companion of a powerful witch, serving as both a protector and a trusted advisor. With his finely honed senses and quick reflexes, Nero is always on the lookout for potential threats to his mistress. He is a skilled hunter, stalking his prey with grace and precision. Despite his fearsome reputation, Nero is a gentle and affectionate cat at heart, and he is fiercely devoted to his mistress. He is often seen following her around, purring contentedly as she goes about her magic. Whether perched atop her shoulder or curled up at her feet, Nero is always by her side, ready to lend his support and guidance.

* * *

>examine vine door
A massive vine door blocks the passage, its thick tendrils coiling and writhing as if alive. The vines are so dense that you can't see what lies beyond them, adding to the sense of mystery and danger.

You reach out tentatively to touch the vines, and they seem to pulse and writhe under your fingers. It's as if they are trying to communicate something to you, but you can't decipher their message.

Despite the eerie feeling that surrounds the vine door, you can't help but feel drawn to it. You have a sense that there is something important waiting for you on the other side, something that could change your life forever.

You see nothing special about the mysterious vine door.

>e
forest
You are standing in a dense forest, surrounded by tall trees and thick underbrush. It's hard to see more than a few feet in any direction. You have no idea how you ended up here, but you know you need to find your way out.

* * *

>s
ravine
You make your way down into a deep ravine, where you find a babbling brook running through the bottom. The water looks clear and cool, and you're tempted to take a drink. You notice a small cave on the other side of the ravine, which might be worth exploring.

>look
ravine
You make your way down into a deep ravine, where you find a babbling brook running through the bottom. The water looks clear and cool, and you're tempted to take a drink. You notice a small cave on the other side of the ravine, which might be worth exploring.

* * *

>look vine door
A massive vine door blocks the passage, its thick tendrils coiling and writhing as if alive. The vines are so dense that you can't see what lies beyond them, adding to the sense of mystery and danger.

You reach out tentatively to touch the vines, and they seem to pulse and writhe under your fingers. It's as if they are trying to communicate something to you, but you can't decipher their message.

Despite the eerie feeling that surrounds the vine door, you can't help but feel drawn to it. You have a sense that there is something important waiting for you on the other side, something that could change your life forever.

You see nothing special about the mysterious vine door.

* * *

>look
garden
The garden is a small, overgrown patch of land located in front of the  hut. The garden is surrounded by a high, wooden fence, topped with barbed wire and warning signs. The fence serves to keep out intruders and to protect the rare and exotic plants that grow within.

The ground is thick with weeds and moss, and the air is heavy with the aroma of herbs and spices. The plants in the garden are a mishmash of medicinal and poisonous varieties, carefully tended to by someone. There are rows of medicinal herbs such as lavender, basil, and chamomile, as well as deadly nightshade, mandrake root, and henbane.

In the center of the garden is a large, ancient oak tree, its branches gnarled and twisted. The tree is said to be enchanted, and is the source of much of the witch's power. It is said that if you are brave enough to pluck a leaf from the tree, you will be granted a wish. But be warned, you get the feeling something is fiercely protective of  garden and will not hesitate to dispose anyone who tries to harm it.

Overall, the  garden is a mysterious and dangerous place, filled with secrets and magic. It is a place to be respected and feared, but also one of great power and potential.

The mysterious vine door prevents you from entering the hut, maybe the piercing green eyed cat can help you enter, you think to yourself.

Nero gazes upon you with his piercing green eyes, smirking.

A massive vine door blocks the passage, its thick tendrils coiling and writhing as if alive. The vines are so dense that you can't see what lies beyond them, adding to the sense of mystery and danger.

You reach out tentatively to touch the vines, and they seem to pulse and writhe under your fingers. It's as if they are trying to communicate something to you, but you can't decipher their message.

Despite the eerie feeling that surrounds the vine door, you can't help but feel drawn to it. You have a sense that there is something important waiting for you on the other side, something that could change your life forever.

>examine mysterious wine door
I only understood you as far as wanting to examine the mysterious vine door.

>w
(first opening the mysterious vine door)
It seems to be locked.

>look mysterious vine door
You see nothing special about the mysterious vine door.

>look for objects
You can't see any such thing.

>look Nero
Nero is a sleek, black feline with piercing green eyes. He is the loyal companion of a powerful witch, serving as both a protector and a trusted advisor. With his finely honed senses and quick reflexes, Nero is always on the lookout for potential threats to his mistress. He is a skilled hunter, stalking his prey with grace and precision. Despite his fearsome reputation, Nero is a gentle and affectionate cat at heart, and he is fiercely devoted to his mistress. He is often seen following her around, purring contentedly as she goes about her magic. Whether perched atop her shoulder or curled up at her feet, Nero is always by her side, ready to lend his support and guidance.

* * *

>look
garden
The garden is a small, overgrown patch of land located in front of the  hut. The garden is surrounded by a high, wooden fence, topped with barbed wire and warning signs. The fence serves to keep out intruders and to protect the rare and exotic plants that grow within.

The ground is thick with weeds and moss, and the air is heavy with the aroma of herbs and spices. The plants in the garden are a mishmash of medicinal and poisonous varieties, carefully tended to by someone. There are rows of medicinal herbs such as lavender, basil, and chamomile, as well as deadly nightshade, mandrake root, and henbane.

In the center of the garden is a large, ancient oak tree, its branches gnarled and twisted. The tree is said to be enchanted, and is the source of much of the witch's power. It is said that if you are brave enough to pluck a leaf from the tree, you will be granted a wish. But be warned, you get the feeling something is fiercely protective of  garden and will not hesitate to dispose anyone who tries to harm it.

Overall, the  garden is a mysterious and dangerous place, filled with secrets and magic. It is a place to be respected and feared, but also one of great power and potential.

The mysterious vine door prevents you from entering the hut, maybe the piercing green eyed cat can help you enter, you think to yourself.

Nero gazes upon you with his piercing green eyes, smirking.

A massive vine door blocks the passage, its thick tendrils coiling and writhing as if alive. The vines are so dense that you can't see what lies beyond them, adding to the sense of mystery and danger.

You reach out tentatively to touch the vines, and they seem to pulse and writhe under your fingers. It's as if they are trying to communicate something to you, but you can't decipher their message.

Despite the eerie feeling that surrounds the vine door, you can't help but feel drawn to it. You have a sense that there is something important waiting for you on the other side, something that could change your life forever.

>look vine door
A massive vine door blocks the passage, its thick tendrils coiling and writhing as if alive. The vines are so dense that you can't see what lies beyond them, adding to the sense of mystery and danger.

You reach out tentatively to touch the vines, and they seem to pulse and writhe under your fingers. It's as if they are trying to communicate something to you, but you can't decipher their message.

Despite the eerie feeling that surrounds the vine door, you can't help but feel drawn to it. You have a sense that there is something important waiting for you on the other side, something that could change your life forever.

You see nothing special about the mysterious vine door.

>loook
That's not a verb I recognise.

>look
garden
The garden is a small, overgrown patch of land located in front of the  hut. The garden is surrounded by a high, wooden fence, topped with barbed wire and warning signs. The fence serves to keep out intruders and to protect the rare and exotic plants that grow within.

The ground is thick with weeds and moss, and the air is heavy with the aroma of herbs and spices. The plants in the garden are a mishmash of medicinal and poisonous varieties, carefully tended to by someone. There are rows of medicinal herbs such as lavender, basil, and chamomile, as well as deadly nightshade, mandrake root, and henbane.

In the center of the garden is a large, ancient oak tree, its branches gnarled and twisted. The tree is said to be enchanted, and is the source of much of the witch's power. It is said that if you are brave enough to pluck a leaf from the tree, you will be granted a wish. But be warned, you get the feeling something is fiercely protective of  garden and will not hesitate to dispose anyone who tries to harm it.

Overall, the  garden is a mysterious and dangerous place, filled with secrets and magic. It is a place to be respected and feared, but also one of great power and potential.

The mysterious vine door prevents you from entering the hut, maybe the piercing green eyed cat can help you enter, you think to yourself.

Nero gazes upon you with his piercing green eyes, smirking.

A massive vine door blocks the passage, its thick tendrils coiling and writhing as if alive. The vines are so dense that you can't see what lies beyond them, adding to the sense of mystery and danger.

You reach out tentatively to touch the vines, and they seem to pulse and writhe under your fingers. It's as if they are trying to communicate something to you, but you can't decipher their message.

Despite the eerie feeling that surrounds the vine door, you can't help but feel drawn to it. You have a sense that there is something important waiting for you on the other side, something that could change your life forever.

>w
hut
You can see a lot of mystical stuff and alchemy stuff all around. There is also a fireplace

The mysterious vine door prevents you from entering the hut, maybe the piercing green eyed cat can help you enter, you think to yourself.

Cauldron is on top of the fireplace. It is boiling something.

* * *

>look mysterious vine door
You see nothing special about the mysterious vine door.

* * *

>talk to nero
Player: Who are you? How did you get in here?

 Nero: I am Nero, a magical feline with the ability to teleport. I have been watching you for some time. The witch wants to keep an out on you.

Player: I'm just trying to get to the hut, I didn't know this was witches, but there's a vine door blocking my way. Do you know how I can get through it?

Nero: Ah, the vine door. It can only be unlocked with a special flower. But this flower does not grow in the garden. It can only be found on the mountain peak, high above the clouds.

* * *

>w
hut
You can see a lot of mystical stuff and alchemy stuff all around. There is also a fireplace

Cauldron is on top of the fireplace. It is boiling something.

>open
(Cauldron)
You open Cauldron, revealing a liquid.

* * *

>examine cauldron
In Cauldron is a liquid.

>drink player
You can't see any such thing.

* * *

>w
hut
You can see a lot of mystical stuff and alchemy stuff all around. There is also a fireplace

Cauldron is on top of the fireplace. It is boiling something.

>open cauldron
You open Cauldron, revealing a liquid.

>fill an empty container with the liquid from the cauldron
That's not a verb I recognise.

>fill an empty container
That's not a verb I recognise.

>i
You are carrying:
  an empty container

>fill an empty container
That's not a verb I recognise.

* * *

>w
hut
You can see a lot of mystical stuff and alchemy stuff all around. There is also a fireplace

Cauldron is on top of the fireplace. It is boiling something.

>spill cauldron
You spill the hot cauldron on the floor. The whole floor is wet. You can see the from dropping from the cauldron. You try to pick it up and find that it is as cold as ice. You keep it.

>i
You are carrying:
  Frozen frog

>eat frozen frog
You wish you had another frozen frog.

>i
You are carrying nothing.

* * *

>w
hut
You can see a lot of mystical stuff and alchemy stuff all around. There is also a fireplace

Cauldron is on top of the fireplace. It is boiling something.

>w
You can't go that way.

>open
(Cauldron)
You open Cauldron, revealing a liquid.

>drink liquid
You feel power flowing over you

>examine cauldron
Cauldron is empty.